أوكي غادي، قدام مكتب الإرشادات السياحية بالضبط.	هناك ، أمام بيانات السائح تماما .
اهوكا غادي، بالضبط قدام البيرو متاع الارشادات السياحية.	هناك ، أمام بيانات السائح تماما .
أنا منعرفش الادريسة هذه قريبة من هوني.	لم اسمع بهذا العنوان من قبل بالقرب من هنا .
عمري ما سمعت بالادريسة هاذي هوني.	لم اسمع بهذا العنوان من قبل بالقرب من هنا .
بقداش فطور الصباح؟	كم تكلفة الإفطار ؟
بقداش فطور الصباح؟	كم تكلفة الإفطار ؟
كيفاش النجم نعاونك؟	كيف أستطيع مساعدتك ؟
كيفاش انجم نعاونك؟	كيف أستطيع مساعدتك ؟
دور على الليسار مع الزنقة الثالثة.	اتجه يسارا عند الناصية الثالثة .
دور الدورة الثالثة عاليسار.	اتجه يسارا عند الناصية الثالثة .
تحب الكريمة و السكر في قهوتك؟	هل تحب أن تضع قشدة وسكر في قهوتك ؟
تحب كريمة و سكر في قهوتك؟	هل تحب أن تضع قشدة وسكر في قهوتك ؟
تنجم تصبلي الميتين دولار من الشاك هذا؟	هل يمكنكم صرف الشيك ذو المائتي دولار الخاص بي ؟
تنجم تصبلي ها الشاك بميتين دولار متاعي؟	هل يمكنكم صرف الشيك ذو المائتي دولار الخاص بي ؟
لو لازم يضهر، كلمني عيشك.	إذا حدث ذلك ، من فضلك أتصل بي .
لو لازم يضهر، كلمني عيشك.	إذا حدث ذلك ، من فضلك أتصل بي .
وين تجي القهوة؟	أين المقهى ؟
ويني القهوة؟	أين المقهى ؟
نحب مريول للأولاد.	أريد جاكيت للأطفال .
نحب مريول متاع صغار.	أريد جاكيت للأطفال .
باهي. خمسة و ثمانين ألف في جواب عادي، تزيد ثلاثة دولار بالظبط باش يوصلك فيسع.	حسنا . إنها تتكلف خمسة وثمانون دولارا في البريد العادي وثلاثة دولارات في التوصيل الخاص .
باهي. مراسلة عادية بخمسة و ثمانين سنت وزايدة تلاثة دولارات بالضبط للمراسلة اللي من النوع لبخاص.	حسنا . إنها تتكلف خمسة وثمانون دولارا في البريد العادي وثلاثة دولارات في التوصيل الخاص .
باش نلقى مشكلة مع الديوانة؟	هل لديك أحذية حريمي عند أصابع القدم ؟
عندك صبابط رسمية يكونو واسعين من شيرة الصوابع؟	هل ستواجهني أية صعوبات في الجمارك ؟
لا. تحب بيت بزوز فروشات لاستخدام شخص برك؟ عندنا وحدة حاضرة.	لا ، هل لي أن أقترح أخذ غرفة ذات سريرين للاستخدام الفردي ؟ فنحن لدينا واحدة .
لا. تحب بيت فيها زوز فروشات نحسبوها لشخص برك؟ عنا وحدة.	لا ، هل لي أن أقترح أخذ غرفة ذات سريرين للاستخدام الفردي ؟ فنحن لدينا واحدة .
نحب كيرلي قوي، يعيشك.	أريد تمويج متقارب لشعري ، من فضلك .
نحب برمانونت قوية، عيشك.	أريد تمويج متقارب لشعري ، من فضلك .
تحب وحدة بيرة.	هي تريد بيرة .
تحب كعبة بيرا.	هي تريد بيرة .
صباح الخير. لاباس؟	صباح الخير . كيف حالك .
سامحني لازمني نطلب منك بطاقة التعريف.	أسف أنني بحاجة إلى أن أطلع على أي مستند لتحديد الهوية .
شنوة الصوص؟	أي نوع من الملابس ؟
أهو بارد شوية. تنجم تسخنه؟	هذا بارد إلى حد ما . هل يمكن أن تقوم بتسخينه ؟
هذا بارد شوية. بش تسخنو؟	هذا بارد إلى حد ما . هل يمكن أن تقوم بتسخينه ؟
شكون اعز صديق عندك؟	من هو أفضل صديق لك ؟
يوم الصحة والرياضة نهار عشرة أوكتوبر، يوم وطني باش نشجع على حياة صحية.	يوم الصحة الرياضية هو يوم العاشر من أكتوبر وهو إجازة قومية الغرض منها تحسين صحة المواطنين .
يوم الصحة والرياضة عشرة أكتوبر هو يوم وطني الهدف منو تدعيم صحة العباد.	يوم الصحة الرياضية هو يوم العاشر من أكتوبر وهو إجازة قومية الغرض منها تحسين صحة المواطنين .
تحب نثبت تحت الكبوت؟	هل تريد أن افحص موتور السيارة ؟
تحبني نشوف تحت الكبوت؟	هل تريد أن افحص موتور السيارة ؟
تنجم تعاوني باش نلقى الفليزة؟	هل لك أن تساعدني في الوصول إلى حقيبتي ؟
تعاوني بش نلقى فاليجتي؟	هل لك أن تساعدني في الوصول إلى حقيبتي ؟
تنجم تاخو كل الأمور من الأول؟	هل ستقوم بعمل الترتيبات مقدماً ؟
من فضلك اعمل التحضيرات اللازمة بالمسبق؟	هل ستقوم بعمل الترتيبات مقدماً ؟
نتلها بروحي. يعيشك.	تقدم إلىّ المساعدة ، شكراً لك .
فما شكون لاهي بيا. عيشك.	تقدم إلىّ المساعدة ، شكراً لك .
وقت توصل الغادي، اطلب من واحد آخر، يعيشك.	عندما تصل هناك أسأل شخص آخر ، من فضلك .
كيف توصل غادي، اسال شكون اخر، يعيشك.	عندما تصل هناك أسأل شخص آخر ، من فضلك .
اهم زوز دولار. حط الباقي عندك.	تفضل هذان دولاران . احتفظ بالباقي .
تفضل زوز دولارات. خلي الباقي عندك.	تفضل هذان دولاران . احتفظ بالباقي .
همبرغر وتشيز برجر، يعيشك.	واحد هامبرجر وواحد شيز برجر ، من فضلك .
اعطيني واحد برغر و واحد شيزبرغر، عيشك.	واحد هامبرجر وواحد شيز برجر ، من فضلك .
بقداش تحسب الاجراءات؟	كم تتقاضى لتطبيع صور الفيلم ؟
كل واحد يحب يخلص وحدو.	كلا منا يريد أن يحاسب على وجبته .
كانت على كرسي في الكلوار.	المكان كان على كرسي في البهو .
كان موجود على كرسي في الاستقبال.	المكان كان على كرسي في البهو .
نحب على قاموس يتحط في الجيب، يعيشك.	أريد قاموس جيب ، من فضلك .
لزوز من الناس في السبعة متاع العشية، باسم واتانابي.	لشخصين عند الساعة السابعة , الاسم وتاناب .
لزوز مالناس مع السبعة. الاسم واتانابي.	لشخصين عند الساعة السابعة , الاسم وتاناب .
فرحانين برشا باش نعتيوك مشروب تختارو إنت، متاع بعد العشاء. تلقى ليستت المشروب المقترحة على الرحلة هذه. في دليل المعلومات متاع المغازة متاعنا.	يسعدنا أن نقدم لك الشراب الذي تريده متبوعاً بالغداء . دليل كامل بالمشروبات التي نقدمها على رحلتنا موجودة في دليل المعلومات الخاص بمجلتنا .
بش يسرنا انو نسربيوكم حاجة تشربوها من اختياركم، و بعد نسربيوكم العشاء. عندكم دليل مفصل عالمشروبات الي نسربيوها في الرحلة هاذي تلقاوه في جزء المعلومات في مجلتنا.	يسعدنا أن نقدم لك الشراب الذي تريده متبوعاً بالغداء . دليل كامل بالمشروبات التي نقدمها على رحلتنا موجودة في دليل المعلومات الخاص بمجلتنا .
وين موجود حانوت الكادوات؟	أين محل الهدايا ؟
وينو حانوت الهدايا؟	أين محل الهدايا ؟
اعطيني فياقة، من فضلك.	أريد منبه ، من فضلك .
اغلب اليابانيين ياكلو القرنيط و السوبية.	معظم اليابانيين يأكلون الأخطبوط والحبار .
منين انجم ناخو تيكايات من الدرجة الثانية لشيكاغو، يعيشك؟	هل يمكنني الحصول على تذكرتين درجة ثانية لشيكاغوا , من فضلك ؟
انجم نقص زوز تساكر درجة ثانية لشيكاغو، يعيشك؟	هل يمكنني الحصول على تذكرتين درجة ثانية لشيكاغوا , من فضلك ؟
مشيت لنيويورك.	لقد ذهبت إلى نيويورك .
شنوة نومرو الرحلة؟	ما هو رقم الرحلة الجوية ؟
شنوة نومرو الطيارة؟	ما هو رقم الرحلة الجوية ؟
ايامات.	لعدة أيام قليلة .
الثاني على الليسار.	الثاني من على اليسار .
الدورة الثانية عاليسار.	الثاني من على اليسار .
الاستقبال؟ فماشي مصحة قريبة من هوني؟	هل هذا مكتب الاستقبال ؟ هل يوجد عيادة قريبة ؟
معايا الاستقبال؟ فمة مصحة قريبة؟	هل هذا مكتب الاستقبال ؟ هل يوجد عيادة قريبة ؟
عشرة دولارات يكفيو للتاكسي؟	هل عشرة دولارات ستكون كافية للذهب بالتاكسي ؟
مطعمه غريب.	أنه ذو مذاق غريب .
مطعمو غريب.	أنه ذو مذاق غريب .
أيه. إستنى، أنا باش نجيبهولك.	نعم . انتظر , سوف احضر لك واحدة .
شطر دبوزة، عيشك.	نصف زجاجة , من فضلك .
موش الهاكة الكل. حويجات موش غاليين.	ليس تماماً . فقط شيء ما غير غالي الثمن .
لا. حاجة ميش غالية و برا.	ليس تماماً . فقط شيء ما غير غالي الثمن .
تلوج على حاجة معينة؟	هل تبحث عن شيء ما ؟
تلوج في حاجة؟	هل تبحث عن شيء ما ؟
أربعة ليلات.	أربع ليالي .
اربعة ليالي.	أربع ليالي .
حاجتي بقلاسة.	أريد بعض الجوارب الرجالي .
حاشتي بشوية كلاسط.	أريد بعض الجوارب الرجالي .
تنجم تعمللنا سوم حيتو مبقع؟	هل تستطيع أن تخفض سعرها لوجود بعض البقع بها ؟
تنجم اطيح في سومو خاترو مبقع؟	هل تستطيع أن تخفض سعرها لوجود بعض البقع بها ؟
راجل دزني. بعد شلقت الي ستوشي ضاع.	ارتطم بي شخص وبعد ذلك اكتشفت أن محفظتي قد سرقت .
راجل طمبج فيا. بعد فقت اللي صتوشي ما فماش.	ارتطم بي شخص وبعد ذلك اكتشفت أن محفظتي قد سرقت .
منيش عارف هزيتشي معايا دبش كافي لخرجة بثلاثة جمعات.	أنا غير متأكد إذا كنت قد حزمت ملابس كافية لرحلة مدتها ثلاثة أيام .
باهي، نحبو نجربو شراب ابيض.	حسناً ، أود أن أجرب النبيذ الأبيض .
كان سأل علي اي حد، قلو راني في القهوة.	إذا سأل أحد عني فأخبره بأني سوف أكون بالمقهى .
متأكد الي انا حتيتها في الجيب الدخلاني متاع الكبوت.	أنا متأكد أني وضعتها بالجيب الداخلي للمعطف .
متاكد الي كنت حاطو في الجيب الدخلاني متاع كبوتي.	أنا متأكد أني وضعتها بالجيب الداخلي للمعطف .
شركة الطيران باش تدفعلي شراء حوايجي الشخصية؟	هل ستدفع لي شركة الطيران لشراء بعض الاحتياجات الشخصية الأساسية ؟
نحب بيت فيها بانو.	أرغب في غرفة بحمام .
نحب بيت فيها بانو.	أرغب في غرفة بحمام .
فمى شكون حلي جوابي.	شخص ما فتح الطرد الخاص بي .
فما شكون حلي الكولي متاعي.	شخص ما فتح الطرد الخاص بي .
اليابانية للطيران، الرحلة رقم واحد، اثنين، ثلاثة.	شركة الخطوط الجوية اليابانية ، طائرة رقم واحد اثنان ثلاثة .
الخطوط الجوية اليابانية، رحلة عدد ميا و تلاثة و عشرين.	شركة الخطوط الجوية اليابانية ، طائرة رقم واحد اثنان ثلاثة .
لازمني نشري الشمبوان.	أرغب في شراء شامبو .
يلزمني نشري شمبوان.	أرغب في شراء شامبو .
تنجم تقلي وقتاش نوصلو لسنتر سيفيك؟	هل بإمكانك أن تخبرين متى نصل إلى مجمع الخدمات العامة .
ميسالش تقلي وقتلي نوصلو للمركز المدني؟	هل بإمكانك أن تخبرين متى نصل إلى مجمع الخدمات العامة .
وين إجي أقرب جزار؟	ـ أين أقرب محل جزارة ؟
نحبوا نقعدوا اربعة ليلات من واحد أوت.	نرغب في أن نقيم أربع ليالي بدءاً من أول أغسطس .
شنوة اسم الوردة هذه؟	ما اسم هذه الوردة ؟
شنوة اسمها النوارة هاذي؟	ما اسم هذه الوردة ؟
خمستاش سبتمبر نهار احترام الرجال الكبار.	الخامس عشر من سبتمبر يوم احترام المسنين .
خمسطاش سبتمبر نهار احترام المسنين.	الخامس عشر من سبتمبر يوم احترام المسنين .
ما فماش صابون في بيتي.	ليس هناك صابون في حجرتي .
ما فماش صابون في بيتي.	ليس هناك صابون في حجرتي .
تنجم تصلح الفورميلار و تبدلو باللي قلتهولي؟	هل يمكنك أن تغير الصياغة طبقاً لما قلته للتو ؟
تنجم تبدل الصيغة تردها الي قلتو توا؟	هل يمكنك أن تغير الصياغة طبقاً لما قلته للتو ؟
تجم تحكي بصوت عالي، يعيشك؟	لا أستطيع أن أفعل ذلك , لكني سوف أضعها في الحقيبة لك .
ميشالش تعلي صوتك شوية، عيشك؟	لا أستطيع أن أفعل ذلك , لكني سوف أضعها في الحقيبة لك .
قداش مزاللو و يخرج؟	كم تستغرق حتى تصبح متاحة .
وينهم المعلومات الرياضية؟	أين الاستعلامات الرياضية ؟
وين اخبار الرياضة؟	أين الاستعلامات الرياضية ؟
الحجم هذا، هذه الي تقولو عليها قديمة، تقضي.	هذا المقاس ، الذي تسميه المقاس العادي ، سوف تجده هنا .
القياس هذا، الي تسميوه قياس عادي، يساعدني.	هذا المقاس ، الذي تسميه المقاس العادي ، سوف تجده هنا .
وين لازمني نبدل الترينو باش نوصل لأدينبره؟	من أي مكان يمكنني أن أغير القطار الذي يوصلني إلى إدنبره ؟
وين لازمني نبدل الترينو بش نمشي لادينبرا؟	من أي مكان يمكنني أن أغير القطار الذي يوصلني إلى إدنبره ؟
نحب نحط هذا في صندوق امانات.	أود أن أضع ذلك في صندوق ودائع آمن .
نحب نحطو في صندوق امانات.	أود أن أضع ذلك في صندوق ودائع آمن .
وين انجم نبدل فلوسي؟	أين يمكنني تغير نقودي ؟
وين انجم نصرف فلوسي؟	أين يمكنني تغير نقودي ؟
انجموا نحتوا حوايجنا في الكار، الى الحوايج الغالين؟	هل يمكننا ترك أشياءنا ما عدا الأشياء القيمة في الحافلة ؟
انجمو نخليو دبشنا، بخلاف الحجات الثمينة، في الكار؟	هل يمكننا ترك أشياءنا ما عدا الأشياء القيمة في الحافلة ؟
باالله السوم هذا متاع شنوة.	أتساءل عن هذه الرسوم الزائدة على فاتورتي .
ياخي شنية هاذي اللي عالفاتورة.	أتساءل عن هذه الرسوم الزائدة على فاتورتي .
باش ندفع خمسين دولار.	أنا سوف أدفع خمسون دولاراً .
نخلص خمسين دولار.	أنا سوف أدفع خمسون دولاراً .
توا وليت نعرف كونه كان غالط.	الآن أعرف . ماذا كان الخطأ . ؟
توا نعرف شنية كانت المشكلة.	الآن أعرف . ماذا كان الخطأ . ؟
قداش انجم نشري افاح بلاش تاكس؟	كم أوقية من العطر أستطيع الحصول عليه من غير رسوم ؟
عندي الحق من كم وقية بارفان مالسوق الحرة؟	كم أوقية من العطر أستطيع الحصول عليه من غير رسوم ؟
في مجال السياحة.	فقط سياحة .
سياحة اكاهو.	فقط سياحة .
هايل برشا، بالله صححهم. كيفاش تحبهم؟	هذا جيد , من فضلك وقع عليهم . كيف تريدها ؟
نحبو شيلة بيلة.	أود الحصول على واحدة كبيرة .
نحب واحد كبير.	أود الحصول على واحدة كبيرة .
انا مصور لحسابي الخاص.	أنا مصور حر .
الي يخدموا في الكازينو انجموا يبدلولك دولاراتك اما تعتيهم حويجة. ايا برا؟	يستطيع الصرافون أن يغيروا دولاراتك من أجل بقشيش الكازينو . هل نذهب ؟
نحضرلك المقترح الجمعة الجاية.	سوف أحضر لك العرض الأسبوع القادم .
يعيشك. بقداش يعملو القواندوات؟	شكراُ لك . كم تكلفة هذا القفاز ؟
يعيشك. بقداش القواندوات هاذوما؟	شكراُ لك . كم تكلفة هذا القفاز ؟
لازمني نمشي. تو نكلمك مبعد.	علىّ أن أذهب ، سأتصل بك لاحقاً .
نحب على كوش للصغيرات.	أريد بعض الحفاضات التى يمكن التخلص منها بعد الاستعمال .
اعطيني كوش جوتابل.	أريد بعض الحفاضات التى يمكن التخلص منها بعد الاستعمال .
منين جاي حوت الفراشات؟	أين نشأت سمكات الفراش هذه ؟
منين اصلهم هالحوت الفراشة؟	أين نشأت سمكات الفراش هذه ؟
تنجم تبدلهم للدولار، يعيشك؟	هل لك أن تغيرهم إلى دولارات من فضلك ؟
تصرفهملي بالدولار، يعيشك؟	هل لك أن تغيرهم إلى دولارات من فضلك ؟
عندنا برشا زهر. عندهم القياس اربعة و ثلاثين في مغازة الا موانا.	نحن محظوظون جداً . لديهم واحدة مقاس أربعة فى متجر ألامونا .
عنا الزهر عالاخر. عندهم واحد قياس اربعة في الحانوت متاع الالا موانا.	نحن محظوظون جداً . لديهم واحدة مقاس أربعة فى متجر ألامونا .
فما ليموزين؟	هل هناك سيارة ليموزين ؟
نحب بيت رايضة.	أُفضلُ حجرة هادئة .
نخير بيت رايضة.	أُفضلُ حجرة هادئة .
نحب اسيتون.	أريد مزيلا لطلاء الأظافر .
نحب شوية اسيتون.	أريد مزيلا لطلاء الأظافر .
نحب عمارة.	أريد بطارية .
اعطيني بيلة.	أريد بطارية .
انجم نكري ادوات متاع غطس؟	هل أستطيع تأجير أداة للتنفس أثناء السباحة ؟
انجم نكري معدات الغطس؟	هل أستطيع تأجير أداة للتنفس أثناء السباحة ؟
في الساك هذا، مهما كان الطقس؟	هل هذه الحقيبة مناسبة لكل حالات الطقس ؟
الساك هذا مناسب مهما كانت حالة الطقس؟	هل هذه الحقيبة مناسبة لكل حالات الطقس ؟
اعطيني كعكة، يعيشك.	أريد كعكة محلاة من فضلك .
نحب نكري كرهبة بوات اوتو على نهارين.	أريد تأجير سلاح آلى لمدة يومين .
نحب نكري كرهبة اوتوماتيك على نهارين.	أريد تأجير سلاح آلى لمدة يومين .
فاتتني الرحلة عشرين الي ماشيا لسانفرانسيسكو.	لم أدرك الرحلة رقم عشرون المتجهة إلى سان فرانسيسكو .
راتيت الرحلة عشرين لسان فرانسيسكو.	لم أدرك الرحلة رقم عشرون المتجهة إلى سان فرانسيسكو .
بقداش للمطار؟	كم سأدفع للوصول إلى المطار ؟
هايل، وقتاش هذا؟	هذا جيد . متى هو ؟
هايل. وقتاش؟	هذا جيد . متى هو ؟
قداش عمرها بنتك؟	كم عمر ابنتك ؟
تنجم تعطينو ليستة الوتلا النضاف و الرخاص؟	هل يمكن أن تدلني على بعض الفنادق الرخيصة والنظيفة ؟
تنجمش تقلي على وتيل نضيف و رخيص؟	هل يمكن أن تدلني على بعض الفنادق الرخيصة والنظيفة ؟
انجم نعطيوك بيت مرتاحة في قصر قديم بحذا نادي قولف.	يمكننا ان نحجز لك غرفة مريحة في قلعة قديمة بالقرب من نادي جولف شهير .
تنجم توريني ون نلقى تكسي؟	هل من الممكن أن تخبرني أين أستطيع أن أحصل على تاكسي ؟
زوز تساكر درجة ثانية، يعيشك.	تذكرتين درجة ثانية من فضلك .
معمل باش نبعث فاكس.	أود أن أرسل فاكس .
نحب نبعث فاكس.	أود أن أرسل فاكس .
نحب حديد متاع سفر.	أريد مكواة سفر .
انجم نعطيك حاجة؟	أيمكنني أن أقدم لك أي شيء ؟
نقدملك اي حاجة؟	أيمكنني أن أقدم لك أي شيء ؟
نهاري؟ منجمش نطلبه من عنده اما شنوة تقصد بالضبط؟	أخشى أن أسأل ، لكن ماذا تعني ؟
نحب وحدة فيها الجوابات اما ماهياش مطوية.	أريد الشخص الذي يعد وثائق عادية في حجم ورقة الخطاب بدون الحاجة إلى طيهم .
عندي حساسية من القطاطس.	أنا شديد الحساسية للقطط .
عندي حساسية عالقطاطس.	أنا شديد الحساسية للقطط .
ايه، ،لازمك رخصة باش تسوق، اه، ولازم عندك ترخيص متاع سياقة تكسي و كراهب طوال.	نعم , لا بد أن يكون عندك رخصة قيادة ، ولا بد أن تحصل على رخصة من لجنة التاكسي والليموزين .
اي، يلزم تكون عندك رخصة سياقة، و اه، يلزم زادة عندك رخصة من هيئة التاكسيات و اليموزين.	نعم , لا بد أن يكون عندك رخصة قيادة ، ولا بد أن تحصل على رخصة من لجنة التاكسي والليموزين .
تفضل، يا سيد.	استمر يا سيدي .
تفضل، سيدي.	استمر يا سيدي .
نحب نريسارفي بيت لليلة.	أود أن أحجز غرفة لهذه الليلة .
لا، التاكس و الخدمات ماهوماش داخلين.	لا ، إنها لا تشمل الضريبة ومصاريف الخدمة .
لا ما فيهش الادائ و حق الخدمة.	لا ، إنها لا تشمل الضريبة ومصاريف الخدمة .
تحب نجريو مع بعضنا بعد نصف النهار؟	هل تريد أن تذهب للتسوق معي بعد الظهر ؟
تحب تخرج معايا نتسوقو ليوم في القايلة؟	هل تريد أن تذهب للتسوق معي بعد الظهر ؟
توا، المكالمة متاعك بدات. تفضل.	الآن ، مكالمتك ردت . تفضل من فضلك .
شنوة نومرو الباب؟	ما رقم البوابة ؟
شنوة نومرو البوابة؟	ما رقم البوابة ؟
شنوة اكثر تذكار يمثل هاواي؟	ما التذكار الخاص بهاواي ؟
انجم نمشي غادي بالمترو؟	أيمكنني أن أذهب هناك بمترو الأنفاق ؟
نحب نجبد شعري.	أريد مجفف .
نحب نجبد شعري.	أريد مجفف .
الكلام هذا باش يعطي حاجة؟	هل نذهب إلى أي مكان متحدثين مثل ذلك ؟
بش نوصلو لحاجة بحديثنا هذا؟	هل نذهب إلى أي مكان متحدثين مثل ذلك ؟
جيت من النورفيج.	أنا من النرويج .
انا مالنورويج.	أنا من النرويج .
امالا. تراه نشوف. ضهرلي تضربت بالهرجان.	بالتأكيد . دعني أراها . أظن أن المرجان جرحك .
بالطبيعة. خليني نشوفو. جرحك المرجان، ضاهرلي.	بالتأكيد . دعني أراها . أظن أن المرجان جرحك .
كان ستحقيت، اعطيني نومرو الشخص المسئول.	لقط للتأكيد ، إعطني رقم المسئول .
فما اوتوروت؟	هل هناك طريق حر ؟
فما اوتوروت؟	هل هناك طريق حر ؟
شبيه ماجاش للحفلة البارح؟	لماذا لم يأت إلى الحفلة أمس ؟
شبيه ما جاش للحفلة لبارح؟	لماذا لم يأت إلى الحفلة أمس ؟
فما اكسيدون.	لقد كان هناك حادث مرور .
صار حادث مرور.	لقد كان هناك حادث مرور .
سامحني، عندي النومرو الغالط.	آسف , لقد اتصلت بالرقم الخطأ .
سامحني، غالط في النومرو.	آسف , لقد اتصلت بالرقم الخطأ .
تشيسبورجر و كاس عصير قارس، يعيشك.	واحد هامبورجر بالجبن و عصير برتقال , من فضلك .
واحد شيزبرغر و واحد عصير، يعيشك.	واحد هامبورجر بالجبن و عصير برتقال , من فضلك .
انجم ناخو زوز تساكر لحفلة الموسيقى للجمعة الجاية؟	هل أستطيع أن الحصول علي تذكرتان للمسرحية الغنائية الجمعة القادمة .
تعطيني زوز تساكر للمسرحية الموسيقية الجمعة الجاية؟	هل أستطيع أن الحصول علي تذكرتان للمسرحية الغنائية الجمعة القادمة .
مسافر آخر قال يحب يبدل بلاسته ببلاستك.	راكب آخر هناك قال انهم يستطيعون أن يبدلوا مقاعدهم معك .
فما راكب من غادي قال ينجم يبدل معاك بالبلاصة.	راكب آخر هناك قال انهم يستطيعون أن يبدلوا مقاعدهم معك .
انجم نزيد في الاقامة؟	هل أستطيع تمديد إقامتي ؟
انجم نزيد نقعد؟	هل أستطيع تمديد إقامتي ؟
قلي، تعرف بلايص سماح يستاهلو نزوروهم و يكونو قراب من هوني؟	يا صاح , أتعرف أي مكان يستحق الرؤية قريبا من هنا ؟
قلي، تعرفش بلاصة تستحق وتحد يمشيلها هوني؟	يا صاح , أتعرف أي مكان يستحق الرؤية قريبا من هنا ؟
بالله اعلمني كيف تلقى ساكي؟	هل من الممكن أن تخبرني عندما تعقروا علي الحقيبة الضائعة ؟
بربي تنجم تعلمني وقتلي تلقاو الساك الضايع؟	هل من الممكن أن تخبرني عندما تعقروا علي الحقيبة الضائعة ؟
شسمو المنتزه؟	ما اسم هذه المحمية ؟
عندي خبش.	أصبت بسحجة .
نجم ناخو غلة؟	هل من الممكن أن احصل علي بعض الفاكهة ؟
تعطيني شوية غلة؟	هل من الممكن أن احصل علي بعض الفاكهة ؟
نجم نفطر تو؟	هل أستطيع تناول غذائي الآن ؟
انجم نفطر توا؟	هل أستطيع تناول غذائي الآن ؟
لازمني نبدل الدولارات هاذم.	أريد أن أستبدل تلك الدولارات .
لازمني تكسي. انا تو في ساوث مين و ليبرتي.	أحتاج إلى تاكسي . أنا في ساوث ماين ، وليبرتي .
حاجتي بتكسي. انا في المقص بين ساوث ماين و ليبرتي.	أحتاج إلى تاكسي . أنا في ساوث ماين ، وليبرتي .
ماهياش تفاحة هاكي خوخة.	هذه ليست تفاحة ولكنها خوخة .
باش نعتيك اوردنونس. هزها للفرمسي.	سوف أعطيك روشتة . خذها إلى الصيدلية .
تو نعطيك ورقة دواء. هزها للسبيسارية.	سوف أعطيك روشتة . خذها إلى الصيدلية .
ناخذوا الطيارة ثلاثة مرات في الجمعة، ثلاث، جمعة و سبت.	نسافر جواً ثلاث مرات في الأسبوع ، أيام الثلاثاء والجمعة والسبت .
نسافرو تلاثة مرات في الجمعة، نهار التلاثة، الجمعة، و السبت.	نسافر جواً ثلاث مرات في الأسبوع ، أيام الثلاثاء والجمعة والسبت .
ايه، عنا. باش نحظروهالك.	نعم لدينا هذا ، سوف نجهزها لك .
اي، عنا. تو نحضروهولك.	نعم لدينا هذا ، سوف نجهزها لك .
لا، نحب كان نتعدى.	ل , ا أريد فقط الزيارة بدون ميعاد .
لا، نحب نتعدالك و برا.	ل , ا أريد فقط الزيارة بدون ميعاد .
انت أمريكي؟	هل أنت أمريكي ؟
انت امريكاني؟	هل أنت أمريكي ؟
كرهبتي تشنقلت.	لقد تعطلت سيارتي .
وين اجي ضل العنين؟	أين مظلل العيون ؟
وينو الفارابوبيار؟	أين مظلل العيون ؟
نحبوا بلاصة هافتة، كان تنجم.	نريد ركناً هادئاً ، إن أمكن .
التكسي فاضي؟	هل هذه السيارة الأجرة متاحة ؟
فاضي التاكسي هذا؟	هل هذه السيارة الأجرة متاحة ؟
هذه محطة اكسبريس؟	هل هذه محطة قطار سريع ؟
هاذي المحطة اكسبريس؟	هل هذه محطة قطار سريع ؟
في اما وقت لازمني نرجع؟	متى ينبغي أن آتي ؟
نحب دبوزة صغيرة متاع شراب ابيض عيشك.	أريد دورقاً صغيراً من الخمر الأبيض .
ايواه. نجم ناخو فطوري من بعد. منيش مريقل توا.	آه . هل يمكنني الحصول على وجبتي فيما بعد ؟ أنا أشعر أنني لست على ما يرام الآن .
هم. انجم ناكل بعد؟ متقلق شوية توا.	آه . هل يمكنني الحصول على وجبتي فيما بعد ؟ أنا أشعر أنني لست على ما يرام الآن .
على فكرة، عندي الجديد. باش نعرس.	بالفعل لدي أخبار . أنا سأتزوج .
سروال آخر؟	بنطلون أخر ؟
فما سراويل اخرى؟	بنطلون أخر ؟
فما حد اقتحم بيتي البارح في الليل.	اقتحمت غرفتي الليلة الماضية .
فما شكون دخلي لبيتي لبارح في الليل.	اقتحمت غرفتي الليلة الماضية .
وريني الحوتة الي شفتها اليوم في كتاب التصاور، عيشك.	أرني السمكة التي رأيتها اليوم في كتاب الصور ، من فضلك .
اقري التعليمات على باكو الماكلة الي مجبود منو الهواء.	انظر التعليمات على علبة الطعام الفارغة .
نحب التساكرر.	أريد نقوداً ورقية .
تحب فلوس اوراق.	أريد نقوداً ورقية .
معندكش دروس تجريبية؟	أليس لديك دروس تجريبية ؟
ما عندكمش دروس تجراب؟	أليس لديك دروس تجريبية ؟
منين نشري تنابر؟	أين يمكنني أن أشتري طوابع بريد ؟
منين انجم نشري تنابر بوسطة؟	أين يمكنني أن أشتري طوابع بريد ؟
جيت من بريطانيا.	أنا من بريطانيا العظمى .
انا من بريطانيا العضمى.	أنا من بريطانيا العظمى .
تو نشوف مع مرتي.	علي أن أفحص ذلك مع زوجتي .
لازمني نثبت مع مرتي.	علي أن أفحص ذلك مع زوجتي .
نحب ترجعولي فلوسي متاع هذا.	أريد أن أحصل على تعويض لذلك .
رجعولي فلوسي متاع هذا.	أريد أن أحصل على تعويض لذلك .
فما تكسيفون قدام البانكة.	يوجد صندوق للهاتف أمام هذا المصرف .
فما تاليفون مقابل اك البانكة.	يوجد صندوق للهاتف أمام هذا المصرف .
نجي نهار تسعة مارس و نرجع نهار اربعطاش.	سأصل في التاسع من مارس وأغادر في الرابع عشر .
غالي شوية، موش هكة؟	هذا غال قليلاً ، ألا تعتقد ؟
عندك الصبات العالي؟	هل لديك كعب ؟
وين يجي طريق الترونو؟	أين المحطة النهائية للحافلة ؟
ويني محطة الكار؟	أين المحطة النهائية للحافلة ؟
عندكم ديسار؟	هل تريد بالحلويات ؟
تحب ديسار؟	هل تريد بالحلويات ؟
تتكلم عليه؟	هل تتحدث ؟
تتكلم انتي؟	هل تتحدث ؟
هي بيدها ليلي انا.	الشيء نفسه لي ، من فضلك .
كيف كيف حتى انا، عيشك.	الشيء نفسه لي ، من فضلك .
سلعتي ما وصلتنيش.	طلبي لم يأت .
اللي طلبتو لتوا لا جاء.	طلبي لم يأت .
فما برشا بلايص متاع ماء شخون.	هناك الكثير من الينابيع الحارة .
فما برشة عيون سخونة.	هناك الكثير من الينابيع الحارة .
بالله بدلي خمسين ألف يان للدولار الامريكي.	من فضلك غير خمسين آلاف ين إلى دولارات أمريكية .
عيشك صرفلي خمسين الف يان للدولار الامريكي.	من فضلك غير خمسين آلاف ين إلى دولارات أمريكية .
هايل بالنسبة ليلي. اما، نحب تكيف.	هذا حسن بالنسبة لي . في الواقع أحب أن أدخن .
مايقلقنيش. تي نحب نتكيف انا.	هذا حسن بالنسبة لي . في الواقع أحب أن أدخن .
نحب شراب احمر.	أريد كوباً من الخمر الأحمر .
نحب كاس شراب احمر.	أريد كوباً من الخمر الأحمر .
الى اذا كانت متاعك، يا سيد. اوه، اوه، نفدلك.	فقط إذا كانت ملكك ، سيدي . هاها ، مزحة صغيرة .
الا كان يبدى متاعك، سيدي. هههه، نفدلك معاك.	فقط إذا كانت ملكك ، سيدي . هاها ، مزحة صغيرة .
اكيد. كيفاش نجم نعاونك؟	بالتأكيد . كيف يمكننا خدمتك ؟
بالطبيعة. كيفاش انجمو نخدموك؟	بالتأكيد . كيف يمكننا خدمتك ؟
بطاقة تعريف؟ ايه. جواز سفر باهي؟	تحقيق شخصية . آه ، هل جواز السفر ينفع ؟
بطاقة تعريف. اه، باهي. ميسالش باسبور؟	تحقيق شخصية . آه ، هل جواز السفر ينفع ؟
نومرو بيتي تلاثة ميا ستة وعشرين. ممكن تهزل حوايج الغسيل متاعي؟	رقم غرفتي هو ثلاثة ستة وعشرين . هل يمكن أن تأخذ الغسيل ؟
نحب سخان ماء.	أريد غلاية .
جيبلي جبن مهروش.	أحضر لي بعض من الجبن المبشور .
جيبلي شوية جبن مرحي.	أحضر لي بعض من الجبن المبشور .
سوارية ينجمو يتغسلو من هوني لغدوة؟	هل يمكن أن أحصل على قمصاني نظيفة غداً صباحاً ؟
قله يكلمني؟	هل لك أن تطلب منه أن يعاود الاتصال بي ؟
تقلو يعاود يكلمني؟	هل لك أن تطلب منه أن يعاود الاتصال بي ؟
علاش؟	لماذا إذاً ؟
سامحني. فما مكتبة قريبة؟	عذراً . هل يوجد محل كتب قريب من هنا ؟
الكار غادي.	الحافلة هناك .
الكار غادي.	الحافلة هناك .
بربي اعطيني زوز رولوات ايزو ميا، فيلم بالالوان، تصاور ستة و تلاثين، يعيشك.	أريد لفتان من ISO مائة ، فيلم ملون ، ستة وثلاثين لقطة ، من فضلك .
نحب هصب الشاك هذا الي فيه سبعين دولار.	أود أن أصرف هذا الشيك بسبعين دولاراً .
نحب نصب الشاك هذا بسبعين دولار.	أود أن أصرف هذا الشيك بسبعين دولاراً .
نحب نشري عشرة تنابر للكارتوات بوستال للباش نبعثهم لليابان، يعيشك.	أود أن أشتري طوابع لعشرة بطاقات بريدية إلى اليابان ، من فضلك .
اعطيني تنابر بش نبعث عشرة كوارط لليابان.	أود أن أشتري طوابع لعشرة بطاقات بريدية إلى اليابان ، من فضلك .
فما بنوك قريبة من محطة الترينو؟	هل توجد مصارف بالقرب من المحطة ؟
فما بانكة بحذا المحطة؟	هل توجد مصارف بالقرب من المحطة ؟
ضهرلي فاما غلطة في الحسبة.	أخشى أن يكون هناك خطأ في الفاتورة .
فما غلطة في الفاتورة هذي.	أخشى أن يكون هناك خطأ في الفاتورة .
تشيز برجر باش نهزه، يعيشك.	واحد شيزبرجر لكي أذهب ، من فضلك .
واحد تشيزبرغر بش نهزو معايا، عيشك.	واحد شيزبرجر لكي أذهب ، من فضلك .
اجري.	أجري .
اجري.	أجري .
الجيلية متاعي تقطعت هوني. متنجمش تخياطهالي، يعيشك؟	هناك قطع في بلوزتي . أتساءل هل يمكنك أن تخيطيه لي ، من فضلك ؟
فما تقطيعة في فيستي. تنجمش تخيطهالي، عيشك؟	هناك قطع في بلوزتي . أتساءل هل يمكنك أن تخيطيه لي ، من فضلك ؟
تنجم تسلفني الخيط متاع التخديم؟	هل يمكن أن تقرضني سلك إمداد ؟
اعطيني لحمة الهام هاذيكا، اما اجود شوية.	أعطني قطعة لحم الخنزير هذه ، ولكن ليس بسمك تلك .
باش نجيو السبعة.	سنأتي في السابعة .
كيف نشوف اسوام طايحة، شيء يضحك كيف تشري كل شيء من اليابان.	عندما أرى الأسعار بهذا الرخص ، يبدو الأمر سخيفاً أن أشتري أي شيء في اليابان .
وقتلي نشوف الرخص هوني، نولي مهبول كان مزلت نشري حاجة ماليابان.	عندما أرى الأسعار بهذا الرخص ، يبدو الأمر سخيفاً أن أشتري أي شيء في اليابان .
ملفاتي زادة تسرقوا.	سرقت سجلاتي ، أيضاً .
كورنو قلاس فانليا، يعيشك.	مخروط من الأيس كريم الفانيليا ، من فضلك .
كورنو ثالجة فانيليا، عيشك.	مخروط من الأيس كريم الفانيليا ، من فضلك .
موافقك. ولى طبيعي.	أوافق . يجب أن تصبح طبيعية جداً .
موافق. لازم تولي حاجة طبيعية.	أوافق . يجب أن تصبح طبيعية جداً .
رد بالك الفراغ، رد بالك الفراغ، اقرب مالباب عيشك.	لاحظ الفجوة ، لاحظ الفجوة ، ثم قرب الأبواب ، من فضلك .
حاجتي بكارطة متاع بانكا.	سأحتاج إلى بطاقة ائتمان .
تنجم تعطيني ملخص للصار.	من فضلك أعطني تقريراً عن الحادث .
لا، يعيشك، موش توا.	لا ، أشكرك حالياً .
لا، يعطيك الصحة توا.	لا ، أشكرك حالياً .
باهي، اقعد معايا. سي ناكاجيما، للة سايتو ضاهرلي موش باش يهزوا عليك. تونحطهم يكلموك بعد مدة؟	حسنا ، ابق على الخط . سيد/ ناكاجيما ، الآنسة/ سايتو يبدو أنها لا ترد على المكالمة . هل تريدني أن أتصل عليها فترة أطول ؟
باهي، عيشك ما تعلقش. سي ناكاجيما، للا سايتو ما تجاوبش. تحبني نعاودلها شوية اخرى؟	حسنا ، ابق على الخط . سيد/ ناكاجيما ، الآنسة/ سايتو يبدو أنها لا ترد على المكالمة . هل تريدني أن أتصل عليها فترة أطول ؟
ضاهرلي نزف برشا.	يبدو أنها نادرة جداً .
يضهر موش منتشر برشة.	يبدو أنها نادرة جداً .
وين اجي البلاصة متاع الاستلام متاع الباقاج للرحلة سبعمية و ثلاثة؟	أين بيان أمتعة الرحلة سبعة صفر ثلاثة ؟
وين استلام الدبش متاع رحلة طيران سبعة ميا و تلاثة؟	أين بيان أمتعة الرحلة سبعة صفر ثلاثة ؟
متشجعش في فريقك بالباهي.	شيء خطأ مع حقيبتك .
عندك مشكلة في القبضة متاعك.	شيء خطأ مع حقيبتك .
فزدت؟	هل هذا سيفسد ؟
هذا يفسد؟	هل هذا سيفسد ؟
لا، يعشك، تو نعمل جهدي باش معاش نشرب.	لا ، شكراً . من الأفضل أن لا أشرب المزيد .
لا، عيشك. يزيني مالشرب خير.	لا ، شكراً . من الأفضل أن لا أشرب المزيد .
نعطيني اسامي الانهج الي فيهم المغازات باش نشري.	من فضلك أخبرني عن بعض الشوارع المناسبة للتسوق .
رد بالك، ماهواش تبلو عادي كيما الاخرين. هذه خدمة متاع تسيريتارو كاتوكا، فنان مشهور في العالم.	الآن ، هذه اللوحة خاصة جداً . رسمها تسوروتارو كاتاأوكا . إنه معروف بأنه فنان عالمي .
هاللوحة هاذي عندها بلاصة خاصة. عملها تسوروتارو كاتاوكا. هو يتسمى فنان عالمي.	الآن ، هذه اللوحة خاصة جداً . رسمها تسوروتارو كاتاأوكا . إنه معروف بأنه فنان عالمي .
نحب برشا الغنى القديم.	لدي تقدير كبير للموسيقى الكلاسيكية .
باهي، شنوة اسم ونومرو الطرف الاخر متاعك، عيشك.	حسنا . ما هو اسم شريكك ورقمه ، من فضلك .
سامحني. خليني نخرج، عيشك.	عذراً . دعني أخرج ، من فضلك .
سامحني، خليني نخرج يعيشك.	عذراً . دعني أخرج ، من فضلك .
تنجم تكلملي خدام يحكي ياباني؟	هل يمكنك أن تستدعي موظفاً يتحدث اليابانية ؟
تعيطلنا موضفين يتكلمو بالياباني؟	هل يمكنك أن تستدعي موظفاً يتحدث اليابانية ؟
ديما نمشيو نزوروا عائلتنا.	نزور أقاربنا كثيراً إلى حد ما .
ميكي هاياكاوا. بيت نومرو سبع مية و ثنين.	ميكي هاياكاوا . هذه غرفة سبعة صفر اثنين .
ميكي هاياكاوا. هاذي بيت سبعة ميا و ثنين.	ميكي هاياكاوا . هذه غرفة سبعة صفر اثنين .
لازمني نعدي الليلة هوني، موش هكا؟ تنجم تعاوني باش ناخذ بيت في وتيل؟	علي أن أمكث هنا الليلة ، أليس كذلك ؟ هل يمكنك مساعدتي حجز غرفة بفندق ؟
لازمني نقعد هوني الليلة، موش هكا؟ تنجم تعاوني بش نحجز بيت وتيل؟	علي أن أمكث هنا الليلة ، أليس كذلك ؟ هل يمكنك مساعدتي حجز غرفة بفندق ؟
معاش برشة. ربع ساعة على اكثر.	يجب أن لا تكون طويلة . خمسة عشر دقيقة في الأغلب .
تقلي بقداش التالفون هذا؟	هل يمكنك أن تخبرني بقيمة هذه المكالمة ؟
بقداش المكالمة هاذي، عيشك؟	هل يمكنك أن تخبرني بقيمة هذه المكالمة ؟
هايل، تجم تقله راني كلمته، يعيشك؟ تو نكلمها من بعد.	حسنا ، هل يمكنك أن تخبرها أنني اتصلت ، من فضلك ؟ سأتصل بها مرة أخرى فيما بعد .
باهي، تنجم تقوللها الي انا تكلمت، يعيشك.	حسنا ، هل يمكنك أن تخبرها أنني اتصلت ، من فضلك ؟ سأتصل بها مرة أخرى فيما بعد .
فما جولة سياحية في الصباح؟	هل توجد أية جولة صباحية ؟
فما رحلات في الصباح؟	هل توجد أية جولة صباحية ؟
تبدل فلوس متاع البرة؟	هل تغير عملات أجنبية ؟
تصرفو فلوس اجنبية؟	هل تغير عملات أجنبية ؟
منين نشري فيلم متاع مصورة؟	أن يمكنني أن أشتري لفة من الفيلم ؟
وين انجم نشري بكرة فيلم؟	أن يمكنني أن أشتري لفة من الفيلم ؟
عندكم بيرة يابانية؟	هل لديك بيرة يابانية ؟
نحب نسجل باقاجي.	أريد تسجيل أمتعتي .
نحب نسجل باقاجي.	أريد تسجيل أمتعتي .
انا الآنسة كاوازي من البيت الف و ستة مية واحداش.	هذه السيدة كاوازو في غرفة رقم ستة عشر أحدى عشر .
معاك انسة كاوازو في البيت سطاش حداش.	هذه السيدة كاوازو في غرفة رقم ستة عشر أحدى عشر .
العفو.	مرحباً بك .
العفو.	مرحباً بك .
شنوة عندكم خير انتم اليابانيين؟ راس العام ولا نوال؟	أيهما أكثر أهمية للشعب الياباني , عيد رأس السنة أم عيد الكريسماس ؟
اما اهم ليكم انتوما اليابانيين، راس العام ولا نوال؟	أيهما أكثر أهمية للشعب الياباني , عيد رأس السنة أم عيد الكريسماس ؟
دقيقة، يعيشك.	لحظة من فضلك .
دقيقة، عيشك.	لحظة من فضلك .
عمر مطلب ضياع.	من فضلك أكمل البيانات الناقصة في التقرير .
عيشك عمر تقرير ضياع.	من فضلك أكمل البيانات الناقصة في التقرير .
من البارح.	منذ أمس .
موجود فيها تامين على التصادم والمسئولية القانونية.	تشمل تأمين ضد التصادم والدين .
عندكمشي انواع سماح متاع شكاكل؟	هل لديكم دبابيس زينة ذات تصميمات رائعة ؟
عندكم مطويات متاع تصاميم باهية؟	هل لديكم دبابيس زينة ذات تصميمات رائعة ؟
نكلم في عيادة عمومية عند ماكيس.	إنني أتصل من كشك عمومي في ماسي .
نكلم فيك من تاكسيفون من مايسيز.	إنني أتصل من كشك عمومي في ماسي .
بقداش سوم البركينق؟	كم أجر الانتظار في الساعة ؟
بقداش الساعة في الباركينق؟	كم أجر الانتظار في الساعة ؟
عندكش مدة فنية تحبها؟	هل توجد أي حقبة معينة للفن تفضلها ؟
فما فترة معينة متاع فن تحبها؟	هل توجد أي حقبة معينة للفن تفضلها ؟
بالله ثبت مرة اخرى.	من فضلك تحقق منها مرة أخرى .
زيد ثبت فيه، عيشك.	من فضلك تحقق منها مرة أخرى .
اهبط لاخر الواد لنصف مايل كيلوماتر هكاكة تو توصل للنادي.	سر في خط مستقيم على طول النهر حوالي نصف ميل . ستصل للمتنزه .
باهي، تو نوصلها للاس فيغاس على خاطرك.	حسناً ، سأرسلها لك إلى لاس فيجاس .
باهي، تو نبعثهولك للاص فيقاس.	حسناً ، سأرسلها لك إلى لاس فيجاس .
نحب على تريكو متاع جريان.	أبحث عن قميص للجري .
تلوج في مراول متاع جري.	أبحث عن قميص للجري .
تحبشي حاجة اخرى من البار؟	هل تود شرب شيئاً من الحانة ؟
تحب تشرب حاجة مالبار؟	هل تود شرب شيئاً من الحانة ؟
تعمل المليح كان تاخذ ترينو الثمنية و نصف.	من الأفضل أن تستقل قطار الثامنة والنصف .
توة موسم المحار، هاكا علاش باهين.	الآن موسم جمع المحار ، لذلك سيكونون في حالة جيدة .
توا فصل المحار، مالا يبداو باهين.	الآن موسم جمع المحار ، لذلك سيكونون في حالة جيدة .
نحب مع منقالة ثانية.	أريد ساعة مستعملة .
باش نسجل في التسعة متاع الليل.	سأقوم بتسجيل الدخول في تمام الساعة الثامنة مساءاً تقريباً .
نسجل مع الثمنية متاع الليل.	سأقوم بتسجيل الدخول في تمام الساعة الثامنة مساءاً تقريباً .
توة امخر. لازمني نمشي.	الوقت يتأخر . يجب أن أرحل .
ماعاش بكري. يلزمني نمشي.	الوقت يتأخر . يجب أن أرحل .
مستعملتش خدمة الغسيل متاعك. تنجم تعاود تثبت هذا؟	لم أستخدم خدمة الغسيل عندكم . أيمكنك التحقق مرة أخرى ؟
ما استعملتش سرفيس الغسيل متاعك. بش تعاود تثبت هاذا؟	لم أستخدم خدمة الغسيل عندكم . أيمكنك التحقق مرة أخرى ؟
لا، ما فماش.	كلاً ، لا يوجد .
هذه آخر محطة؟	هل هذه هي آخر محطة ؟
هاذي اخر محطة؟	هل هذه هي آخر محطة ؟
كلمه.	لنتصل به .
حر بارشا؟	هل هذا المتبل حار ؟
حار هذا؟	هل هذا المتبل حار ؟
وين نلقى كار متاع توريست؟	أين يمكنني أن أستقل حافلة لمشاهدة المعالم ؟
وين انجم نلفى كار متاع توريست؟	أين يمكنني أن أستقل حافلة لمشاهدة المعالم ؟
اي، نحب نشوف تامعالم متاع المدينة.	أجل ، أريد مشاهدة معالم المدينة .
يعيشك على اسعافي.	شكراً على كرم ضيافتك .
يعطك الصحة عالضيافة.	شكراً على كرم ضيافتك .
الصدق اعز حاجة في السياسة.	الأمانة هي السياسة المثلى .
احسن سياسة هي الصدق.	الأمانة هي السياسة المثلى .
تنجم تقيمني الستة، يعيشك؟	هل لك أن توقظني في تمام السادسة من فضلك ؟
تقيمني الستة، يعيشك؟	هل لك أن توقظني في تمام السادسة من فضلك ؟
بقداش شطر نهار؟	كم السعر لنصف يوم ؟
اسمي كانجي.	أنا كينجي .
انا كانجي.	أنا كينجي .
تعرف بلايص سماح نمشيولهم في شيكاغو؟	هل تعرف أي أماكن جيدة لمشاهدتها في شيكاجو ؟
تعرفشي بلايص باهين واحد يزورهم في شيكاغو؟	هل تعرف أي أماكن جيدة لمشاهدتها في شيكاجو ؟
هايل، كان تشد فيا، تو نمشي معاك.	حسناً ، في حالة إصرار كليكما , سأذهب معكما .
باهي، كان الزوز شادين صحيح، تو نمشي معاكم.	حسناً ، في حالة إصرار كليكما , سأذهب معكما .
نحب نعمل حجز للثلاثة و نصف متاع القايلة.	أريد القيام بحجز للساعة الثالثة والنصف ظهراُ .
نحب نحجز للتلاثة و نص متاع القايلة.	أريد القيام بحجز للساعة الثالثة والنصف ظهراُ .
حكة السلامة، عيشك.	خزينة الودائع , من فضلك .
اختار الشراب الي يساعدك.	من فضلك أحضر نبيذاً مناسباُ .
عيشك اختار شراب مناسب.	من فضلك أحضر نبيذاً مناسباُ .
لازمني نخلص الليسانس؟	هل مطلوب منى دفع ثمن الغاز ؟
سارق. شدوه.	لص . أمسكوا به .
سارق، شدوه.	لص . أمسكوا به .
بالله تعطيني صرف، يعيشك.	من فضلك أعطني بعض النقود الفكة .
اعطيني شوية صرف عيشك.	من فضلك أعطني بعض النقود الفكة .
صغرونة و سميحة.	إنها صغيرة الجسم وذكية .
ضريفة و حلوة.	إنها صغيرة الجسم وذكية .
في الطبق، يعيشك.	مقلي من فضلك .
مقلي، يعيشك.	مقلي من فضلك .
الغسيل متاعي ما رجعش.	غسيلي لم يرجع حتى الآن .
مازالو ما رجعوليش حوايجي الي تغسلت.	غسيلي لم يرجع حتى الآن .
بالمناسبة، ما عندك ما تعمل نهار السبت الجاي؟	على فكرة , هل أنت غير مشغول السبت القادم ؟
اي باهي، يمكن سمعناكم بالباهي.	حسناً ، إذن , ربما سننسجم مع بعضنا .
تصرفت معايا تقولشي عليا متسول.	إنها عاملتني كما لو كنت متسولاُ .
عاملتني كايني طالب.	إنها عاملتني كما لو كنت متسولاُ .
فهمتك. زادا، تنجمش تعاوني في مشكة اخرى؟	أفهم . هل يمكنك مساعدتي في هذا المشكلة الأخرى أيضاُ ؟
تنجم تريقلي مريات الشمس على قياسي؟	هل يمكنك وضع عدسات نظر في هذا النظارة الشمسية ؟
ممكن تردلي بلار مريات الشمس هاذي متاع نضر؟	هل يمكنك وضع عدسات نظر في هذا النظارة الشمسية ؟
ملا كلب سمح. شنوة نوعه؟	يا لها من كلاب ذكية . من أي فصيلة ؟
محلاه الكلب. شنوة نوعو؟	يا لها من كلاب ذكية . من أي فصيلة ؟
طيحت فرشيطتي. عيشك جيبلي وحدة اخرى.	وقعت منى الشوكة . من فضلك أحضر واحدة أخرى .
كان باهي.	كان هذا ممتعاً .
مالا. امشي طول و دور على الليمين مع الشارع الثالث. تو تلقاه على يمينك.	بالتأكيد . سر في خط مستقيم ثم اتجه يميناُ عند الناصية الثالثة . ستجده على يمينك .
تعرف كاتي؟ هذه حفلة عيد ميلاده.	أتعرف كاثي ؟ إنه عيد ميلادها .
عندك رسم توضيحي؟	هل لديك لوحة موضوع عليها الألوان ؟
عندكم جدول الوان؟	هل لديك لوحة موضوع عليها الألوان ؟
اما قله، انت، كيفاش يعرف كان صحيح؟	لكن ، هو , يا رجل كيف أعرف أنه الشيء الحقيقة ؟
اما، هو، يا راجل، كيفاش نعرف الي هذاكا هو الصحيح؟	لكن ، هو , يا رجل كيف أعرف أنه الشيء الحقيقة ؟
هذا رجعت فلوسو؟	هل يمكنني شرائها معفاة من الضرائب ؟
انجم نشريه ما نغير ما نخلص عليه اداء؟	هل يمكنني شرائها معفاة من الضرائب ؟
ما انجمش نحط دبشي تحت الكرسي. تخليهولي عندك، يعيشك؟	لا يمكنني وضع الأمتعة تحت المقعد . هل لك أن تحتفظ بها لأجلي من فضلك ؟
تنجم تحط الفاليز في الكوفر يعيشك؟	هل يمكن أن تضع حقيبة السفر هذه في صندوق السيارة .
كيف نخرج توة، باش نمشي نلوج عليه.	أنا خارج الآن . لذلك سآخذها .
خارج انا توا، مالا تو نتعدى نهزو.	أنا خارج الآن . لذلك سآخذها .
بالله ابعث واحد يلوج على باقاجي الستة و نصف.	من فضلك أرسل أحداً للطابق العلوي ليأخذ حقائبي الساعة السادسة والنصف .
عيشك ابعثلي شكون بش يهبطلي دبشي مع الستة و نص.	من فضلك أرسل أحداً للطابق العلوي ليأخذ حقائبي الساعة السادسة والنصف .
شنوة نوع الخبز الي عندك؟	ما نوع الخبز لديكم ؟
شنوة الخبز الي عندكم؟	ما نوع الخبز لديكم ؟
وين الاسانسور؟	أين المصعد ؟
فماشي شكون يعرف يعزف بابيانو؟	هل يوجد أحد يستطيع العزف على البيانو ؟
فما شكون يعرف يلعب عالبيانو؟	هل يوجد أحد يستطيع العزف على البيانو ؟
ايه، اما ما نتصورش عندنا الوقت باش نقعدوا زوز ليلات. تنجم تاخذلي بيت بزوز فروشة في الوتيل هذا لليلة اثناش مارس اكهاو؟	شكراً . لكنني لا أعتقد أن عندي وقت للإقامة لمدة ليلتين . هل يمكنك حجز غرفة بسريرين لي في ذلك الفندق ليلة الثاني عشر من مارس فقط ؟
عيشك، اما ما نتصورش عندي وقت باش نقعد ليلتين. تنجم تحجزلي في الوتيل بيت بزوز فروشات هاذاكا لليلة اثناش مارس اكاهو؟	شكراً . لكنني لا أعتقد أن عندي وقت للإقامة لمدة ليلتين . هل يمكنك حجز غرفة بسريرين لي في ذلك الفندق ليلة الثاني عشر من مارس فقط ؟
مازلنا مخذيناش قرار.	لم نقرر بعد .
صاحبي عثر و ساقو تلوات.	تعثر صديقي والتوي كاحله .
عشيري عثر و فصع ساقو.	تعثر صديقي والتوي كاحله .
باش نجرب القلاس.	سأجرب بعضاً من الشراب المثلج .
نحب نجرب شوية شربات.	سأجرب بعضاً من الشراب المثلج .
فما مطعم تايلندي بجنبنا؟	هل يوجد مطعم تايلاندي قريب من هنا ؟
فما مطعم تايلندي موش بعيد؟	هل يوجد مطعم تايلاندي قريب من هنا ؟
بجنب العمارة الكبيرة. ارجع للضوء، بعد دور على الليسار.	إنها بجور ذلك المبنى المرتفع . لذلك ارجع في نفس الطريق الذي أتيت منه حتى إشارة المرور . ثم اتجه يساراً .
بجنب البنية الطويلة هاذيكا بالضبط. مالا، ارجع منين جيت حتى للضوء. بعد، دور عاليسار.	إنها بجور ذلك المبنى المرتفع . لذلك ارجع في نفس الطريق الذي أتيت منه حتى إشارة المرور . ثم اتجه يساراً .
لازمني ناخذ طيارة للوس انجلس غدوة الصباح بكري.	علي أن ألحق طائرة متجهة للوس أنجليس باكر صباح غد .
"اي، نقترح عليك بكل ثقة ""جولة لمدينة سان فرانسيسكو"" هاذي. تعطيك نضرة شاملة على سان فرانسيسكو."	إذاً يمكنني بكل ثقة أن أزكي برج مدينة سان فرانسيسكو . فهذا يعطيك فكره عن سان فرانسيسكو .
مالا نجم ننصح بثقة بالمحواسة هاذي متاع مدينة سان فرانسيسكو. تعطيك اهم ما فما في سان فرانسيسكو.	إذاً يمكنني بكل ثقة أن أزكي برج مدينة سان فرانسيسكو . فهذا يعطيك فكره عن سان فرانسيسكو .
نحب نكلم سيقورتة.	أريد الحصول على تأمين .
تحب تشري روبة.	تريد أن تشتري ثوبا .
بقداش نمشي للوتيل هذا بالتكسي؟	كم أجرة التاكسي حتى هذا الفندق ؟
بقداش تاكسي للوتيل هذا؟	كم أجرة التاكسي حتى هذا الفندق ؟
وين بيت الراحة؟	أين الحمام ؟
باش تدخل للبنية هذه بالفلوس؟	هل يكلفني دخول هذا المبنى أي أموال ؟
اعمل كيفما تحب.	قم بها بطريقتك .
كيما تحب.	قم بها بطريقتك .
البرسانة تبلاكات.	النافذة محشورة .
الشباك واحل.	النافذة محشورة .
نصف وقية من شانيل نومرو خمسة، يعيشك.	نصف أوقية من شانيل رقم خمسة من فضلك .
نصف وقية من شانيل خمسة، يعيشك.	نصف أوقية من شانيل رقم خمسة من فضلك .
تحب شوية قهوة؟	ما رأيك في بعض القهوة ؟
لازمني تسكرة؟	هل أنا بحاجة إلى تذكرة ؟
نحتاج تسكرة؟	هل أنا بحاجة إلى تذكرة ؟
بقداش الخدمة؟	ما هي تكلفة الخدمة تقريبا ؟
قداش وقت من هوني؟	كم المدة التي يستغرقها من هنا ؟
قداش من هوني؟	كم المدة التي يستغرقها من هنا ؟
كريمة و سكر؟	كريمة وسكر ؟
كريمة و سكر؟	كريمة وسكر ؟
تعملوا تخفيض للمشاركين؟	هل ثمة تخفيضات للأعضاء المشاركين ؟
عندكم تخفيض للاعضاء؟	هل ثمة تخفيضات للأعضاء المشاركين ؟
فم سوبر اكسبريس التسعة و نصف؟	هل هناك قطار فائق السرعة في التاسعة والنصف ؟
فما ترينو اكسبريس مع التسعة و نص؟	هل هناك قطار فائق السرعة في التاسعة والنصف ؟
ثبت زيت الفران و الموتور. موتورك ضاهرلي باش يعوق.	دعني افحص سائل الفرامل والمحرك . يبدو أن محرك سيارتك قد أوشك علي التوقف .
خليني نتققد زيت الفران و الموطور. الموطور متاعك قريب يسكت.	دعني افحص سائل الفرامل والمحرك . يبدو أن محرك سيارتك قد أوشك علي التوقف .
ماكانتش غلطتي.	لم يكن خطئي .
ماكانتش غلطتي.	لم يكن خطئي .
ثم قصة متاع ضوء.	لا كهرباء .
الضوء مقصوص.	لا كهرباء .
خبرت الشرطة.	سوف أبلغ الشرطة بذلك .
تو نبلغ للشرطة.	سوف أبلغ الشرطة بذلك .
كل واحد لازمه يخلص ماكلته؟	هل سيحاسب كل واحد منا على مشروباته منفردا ؟
كل واحد لازم يخلص مشروباته؟	هل سيحاسب كل واحد منا على مشروباته منفردا ؟
بين تلاثين و خمسين دولار الليلة.	في أي مكان من ثلاثين حتى خمسين دولارا لليلة .
بالله صلحلي هذه.	من فضلك ، اصلح هذه .
رقعهولي عيشك.	من فضلك ، اصلح هذه .
في راس العام. و في المناسبات كيف العراس و توزيع الجوائز او الجنازات.	في أيام السنة الجديدة . وفي مناسبات خاصة مثل حفلات الزواج ومراسم منح الجوائز أو في العزاء .
علاش ما تهديهش هدية؟	لماذا لا تعطيها هدية ؟
شبيه ما تعطيهاش هدية؟	لماذا لا تعطيها هدية ؟
ضربتني في الجنب.	لقد انتقدتني ضمنا .
دزتني في الجنب.	لقد انتقدتني ضمنا .
انجم نجي الساعتين.	يمكن أن أحضر في الساعة الثانية .
انجم نتعدالك مع الساعتين.	يمكن أن أحضر في الساعة الثانية .
هذا باقاج الرحلة جيه إيه إل صفر واحد؟	هل هذه هي حقائب الرحلة جال صفر واحد ؟
هذا باقاج رحلة جيه إيه إل صفر واحد؟	هل هذه هي حقائب الرحلة جال صفر واحد ؟
هذه رحلتي لولة لباريس.	هذه هي رحلتي الأولى إلى باريس .
ادخل، من فضلك.	تعالى ، من فضلك .
ادخل، يعيشك.	تعالى ، من فضلك .
منين نطلعوا للبابور؟	متي سنستقل القارب ؟
وقتاش نركبو في البطو؟	متي سنستقل القارب ؟
ما عندناش ساك ما اكبر، تو نحطه في الساك الكبير هذا متاع البلاستيك.	ليس لدينا حقيبة لمثل هذه الكمية ولذلك سأضعها في هذه الحقيبة البلاستيكية الكبيرة .
ما عناش ساك يرفع الكمية هاذي مالا تو نحطلك في الشكارة البلاستيك الكبيرة هاذي.	ليس لدينا حقيبة لمثل هذه الكمية ولذلك سأضعها في هذه الحقيبة البلاستيكية الكبيرة .
نحب نلعب تنس.	أود لعب التنس .
نحب نلعب تنس.	أود لعب التنس .
ثما عصير اناناس، عصير قارس و عصير طماطم.	يوجد عصير أناناس وبرتقال وطماطم .
الشيرة الليسار من الليتاج هذا، بجنب الدروج الي يتحركوا.	الجانب الأيسر من هذه الدور بجوار المصعد .
في الطاق هذا عايسار، بحذى الدروج.	الجانب الأيسر من هذه الدور بجوار المصعد .
ما تحبش تشوف فيلم آخر؟	ما رأيك في مشاهدة فيلم آخر ؟
ما تحبش نتفرجو في فيلم اخر؟	ما رأيك في مشاهدة فيلم آخر ؟
بالله بدلي شاك السفر هذا بفلوس.	من فضلك ، بدلي شيك المسافرين إلي نقود .
نجم يمكن نعطيك اجابة صحيحة بعد وحدة و الى زوز تقديمات.	ربما أعطيك إجابة أفضل من تلك بعد عرضين .
شنية المقطوعة الموسيقية الي تلعب تو؟	ما هي المسرحيات الموسيقية المعروضة حاليا ؟
عندك مراية؟	هل لديك مرآة ؟
عندك مراية؟	هل لديك مرآة ؟
ما تنجمش تهز فوشيك لكندا.	لا يمكنك جلب الألعاب النارية إلى كندا .
ما تنجمش تدخل فوشيك لكانادا.	لا يمكنك جلب الألعاب النارية إلى كندا .
مرتك صنافة هايلة.	ما أروع زوجتك من طاهية .
ملا صنافة مرتك.	ما أروع زوجتك من طاهية .
تحتاج مساعدة؟	هل تريد أي مساعدة ؟
تنجم تاخذلي تكسي الستة متاع الصباح، يعيشك؟	هلا حجزت لي تاكسي الساعة السادسة صباح غد , من فضلك ؟
عيشك تحجزلنا تكسي لستة مالناس لغدوة الصباح، عيشك؟	هلا حجزت لي تاكسي الساعة السادسة صباح غد , من فضلك ؟
شنوة تحب كيف تدخل؟	ماذا تفضل مع طبقك الرئيسي .
فما بارشا عباد هوني، موش هكا؟	هذا المكان مكتظ بالناسب ، أليس كذلك ؟
سامحني. تو يحضروا في دريج.	عفواً . ستكون جاهزة في غضون خمس دقائق .
شدتني يبوسية في كرومتي كيف رقدت.	عانيت من ألم في الرقبة أثناء نومي ؟
عنزت رقبتي و انا راقد.	عانيت من ألم في الرقبة أثناء نومي ؟
باهي. مافما حتى مشكل. انجم نشوف باسبورك؟	نعم ، لا توجد مشكلة . هل من الممكن أن أرى جواز سفرك ؟
اي، مافماش مشكلة. انجم نشوف باسبورك؟	نعم ، لا توجد مشكلة . هل من الممكن أن أرى جواز سفرك ؟
في اما وقت لازمني نكون في المحطة؟	متى يتعين علي أن أكون في المحطة ؟
وقتاش يلزمني نكون في المحطة؟	متى يتعين علي أن أكون في المحطة ؟
بحذا بيت الامانات.	بجوار حجرة الإيداع .
بجنب بيت الامانات.	بجوار حجرة الإيداع .
تشرفت بالحديث معاك.	إنه لمن دواعي السرور أن أتحدث معك .
تمتعت بالاقامة متاعي. عيشك.	لقد تمتعت بإقامتي . شكراً لك .
البحر من هوني. ملا منظر سمح.	الشاطئ أسفل يمينا . ياله من منظر رائع .
الشط تحتنا بالضبط. منضر هايل.	الشاطئ أسفل يمينا . ياله من منظر رائع .
عيشكم على سماعكم سيدة ماكغير. اهو، تفضلي، يعيشك.	شكراً لك على الانتظار ، يا أستاذه مكجوير . هاك هو . امض من فضلك .
عندك تصويرة متاع هوية؟	هل لديك أي صورة لبطاقة هوية ؟
عندك تصويرة نص؟	هل لديك أي صورة لبطاقة هوية ؟
سبعة، يعيشك.	سبعاً ، من فضلك .
سبعة، عيشك.	سبعاً ، من فضلك .
نحب نبعث هذا للدافان. وقتاش يجهز؟	أريد أن أرسل هذا إلى المغسلة . متى ستكون جاهزة ؟
عندي سروال مخطط.	لقد خلعت البنطلون .
ايه. باقاج واحد اخر جاني للبيت متاعي. تنجم تثبت، يعيشك؟	نعم . تم نقل أمتعة شخص آخر إلى غرفتي تواً . من فضلك ، هل من الممكن أن تقوم بفحصها ؟
اي. فما دبش موش متاعي وصلوه لبيتي توا توا. تتأكد منه، عيشك؟	نعم . تم نقل أمتعة شخص آخر إلى غرفتي تواً . من فضلك ، هل من الممكن أن تقوم بفحصها ؟
تنجم تفسرلي اكثر بازيد معلومات؟	هل من الممكن أن تفصل أكثر ؟
ميسالش تزيد تفسرلي باكثر تفاصيل؟	هل من الممكن أن تفصل أكثر ؟
رقدتشي بالباهي؟	هل استرحت في نومك ؟
تنجم تنزل على قرص التصوير؟	هلا ضغطت على زر مصراع النافذة ؟
زوز مفاتح، يعيشك.	مفتاحين من فضلك ؟
زوز مفاتح، عيشك.	مفتاحين من فضلك ؟
في اخر الكولوار.	في نهاية الممر .
موجود في اخر الكولوار.	في نهاية الممر .
نمشيو بالكار؟	هل سنذهب بالحافلة ؟
كيفاش ماشية لعبتك هالليام؟	كيف حال اللعب معك هذه الأيام ؟
تلعب مليح الايامات؟	كيف حال اللعب معك هذه الأيام ؟
مافما حتى مشكلة. كان تجي نهار خمسة سبتمبر، تنجم تتمتع بفيلم علمي خاطر عنا يوم مفتوح كل اول نهار جمعة مالشهر.	لا توجد مشكلة . إذا حضرت في الخامس من سبتمبر ، فسيكون بإمكانك الاستمتاع بعرض فيلم علمي لأن عندنا يوماً خاصاً مفتوحاً أول يوم جمعة من كل شهر .
عندكشي جولة اخرى؟	هل لديكم أية جولة سياحية أخرى ؟
عندكم رحلات سياحية اخرين؟	هل لديكم أية جولة سياحية أخرى ؟
باهي. تخفيض بخمسة بالمية. يمشي معاك؟	حسنا . خصم خمسة في المائة . هل يوافقك لك ؟
باهي، نطيحلك خمسة بالميا. باهي؟	حسنا . خصم خمسة في المائة . هل يوافقك لك ؟
ماشي لباريس.	إنني ذاهب إلى باريس .
موش اخر نوع، موش هكا؟	إنها ليست أحدث طراز ، أليس كذلك ؟
هذا موش اجد موديل، موش هكا؟	إنها ليست أحدث طراز ، أليس كذلك ؟
مبرمج للثمنية و نص متاع الليل بالتوقيت المحلي.	موعده المقرر هو الثامنة والنصف مساءْ بالتوقيت المحلي .
خوذلنا تصويرة قدام البنية هذه، يعيشك.	أظهر هذا المبنى معنا , من فضلك .
خوذ البنية معانا، عيشك.	أظهر هذا المبنى معنا , من فضلك .
باهي. ناخذ صحن متوسط و كفتة روز.	حسناً . أريد سلطانية من الحجم المتوسط ، وكرات الأرز .
باهي. اعطيني صحفة متوسطة و كعبورة روز.	حسناً . أريد سلطانية من الحجم المتوسط ، وكرات الأرز .
عنده منضر شنوة؟	كيف يبدو هذا ؟
نحب نشوف كيما الي معلق البرا، يعيشك.	أريد أن أرى ذاك الذي في نافذة العرض ، من فضلك .
نحب نشوف هاذيكا الي في الفترينة، يعيشك.	أريد أن أرى ذاك الذي في نافذة العرض ، من فضلك .
من غير اسئلة. احنا في عطلة. منحبش نقعد في بيت اللوتيل باش نتفرج على البايز بول في التلفزة. نحب نمشي نشوف الماتش على البلاصة.	مستحيل . نحن في إجازة . إنني أرفض الجلوس في غرفة بالفندق ومشاهدة البيسبول في التلفاز . أريد الذهاب لمشاهدة مسرحية .
لا مستحيل. احنا في عطلة. نرفض باش نقعد في بيت وتيل نتفرج في كرة المضرب في التلفزة. نحب نمشي نتفرج في مسرحية.	مستحيل . نحن في إجازة . إنني أرفض الجلوس في غرفة بالفندق ومشاهدة البيسبول في التلفاز . أريد الذهاب لمشاهدة مسرحية .
انجم نشده؟	هل بإمكاني اللمس ؟
انجم نمسو؟	هل بإمكاني اللمس ؟
تنجم تجي لهوني بش تصلحو؟	أيمكنك الحضور إلى هنا لإصلاحه ؟
نحب على الفيبر الاصطناعي.	أريد بعض الألياف الصناعية .
اعطيني شوية خيوط اصطناعية.	أريد بعض الألياف الصناعية .
اسمي تارو تاناكا. عندي حجز.	"اسمي "" تارو تاناكا "" لدي حجز مسبق ."
نحب كريمة للتنظيف .	أريد بعضاً من كريم التنظيف .
نحب شوية كريمة متاع تنضيف.	أريد بعضاً من كريم التنظيف .
نحب تريكو صوف يديه طوال.	أريد رداءا ذات أكمام طويلة .
نحب مريول رياضة باليدين.	أريد رداءا ذات أكمام طويلة .
سرقولي ساكي.	لقد سُرقت حقيبتي .
طريقي و طريقك يتقابلو برشة مرات، موش هكة؟	لقد تقابلنا بالصدفة لعدة مرات ، أليس كذلك ؟
نجم نعاود نشوف الموني؟	هل يمكنني أن ألقي نظرةً أخرى على قائمة الطعام ؟
نتصوره مازال مبتدئ.	لا تزال تبدو عليهم علامات المرض وشحوبة الوجه .
يظهرلي مازالو مبتدئين شويا.	لا تزال تبدو عليهم علامات المرض وشحوبة الوجه .
قداش؟	كم عددها ؟
قداش؟	كم عددها ؟
بالفراز، يغيشك.	فراولة ، من فضلك .
لا، مازال بكري. فما برشا اختيارات.	لا ، ليس بعد ، هناك الكثير نختار فيه .
لا، مازال. فما برشا شوا.	لا ، ليس بعد ، هناك الكثير نختار فيه .
تنجم تنقصله في اليدين؟	هل لك أن تقصّر الأكمام ؟
تنجم تقصرلي ليدين؟	هل لك أن تقصّر الأكمام ؟
سامحني ما فما حتى ملعب قولف قريب.	أخشى أن لا يكون هنا أية دورة لتعليم الجولف .
سامحني ما فما متاع قولف في لحواز.	أخشى أن لا يكون هنا أية دورة لتعليم الجولف .
تنجم توريني ثاني خاتم من الليسار؟	هل لك أن تريني الخاتم الثاني من جهة اليسار ؟
حاولت نعدي تالفون للبرا. وصلتوا؟	لقد حاولت إجراء مكالمة دولية ، هل نجح ذلك معك من قبل ؟
حاولت نعمل مكالمة للخارج. ياخي إنت أصلا وصلت؟	لقد حاولت إجراء مكالمة دولية ، هل نجح ذلك معك من قبل ؟
ايه باهي هذا على خاطر نشوفوا في العلم قدام البوستة.	نعم ، هي ، لأنك تستطيع أن ترى العلم أمام مكتب البريد .
إيه هذا هو على خاطر نشوفو في العلم قدام البوسطة.	نعم ، هي ، لأنك تستطيع أن ترى العلم أمام مكتب البريد .
نحب نعدي تاليفون باكارطة متاع البانكا.	أود إجراء مكالمة هاتفية باستخدام بطاقة ائتمان .
نحب نعمل تالفون بالكارت كريدي.	أود إجراء مكالمة هاتفية باستخدام بطاقة ائتمان .
نحب متاعي باش نهزه.	أريد ما يخصني لكي أرحل .
دوب ما يوصل، نوصلوه للعنوان متاعك على حسابنا.	لدي وصولها ، سوف ندفع ثمن شحنها إلى عنوان منزلك .
وقت إلي يوصل، تو ننعتوه على عنوان بيتك على حسابنا.	لدي وصولها ، سوف ندفع ثمن شحنها إلى عنوان منزلك .
اوه، باهي، فهمت. تو نجي بحذاك.	أوه ! موافق ، لقد فهمت ، سوف آتي إلى مكانك .
أوه، باهي، فهمت. تو نجي بحذاك.	أوه ! موافق ، لقد فهمت ، سوف آتي إلى مكانك .
لا، هذا يكفي.	لا ، هذا يكفي .
لا، هذا يكفي.	لا ، هذا يكفي .
انجم ناخذ كوفيرتة و مخدة؟	هل لي أن آخذ بطانية ووسادة ؟
تنجم تجي هوني بأسرع ما يمكن، يعيشك؟	هل يمكنك أن تحضر هنا قريباً بقدر المستطاع ، من فضلك ؟
كويس قهوة، يعيشك.	قدحاً من القهوة , من فضلك .
فنجان قهوة، يعيشك.	قدحاً من القهوة , من فضلك .
تنجم تعاود القياس بثلاثة صنتيم؟	هل لك بأن تضيق منطقة الوسط سنتيمترات ؟
تنجم تنقص في القياس بتلاثا صنتمتر؟	هل لك بأن تضيق منطقة الوسط سنتيمترات ؟
عندي نفس العمر.	إنني في نفس السن .
عندي نفس العمر.	إنني في نفس السن .
لازمنا نتعداو للتصويت؟ و كان موش هكا، ضاهرلي وصلنا لنتيجة كوني باش نقول لمجلس ادارتنا غدوة الصباح.	هل نحتاج إلى طرح هذا للتصويت ؟ إن لم نكن في حاجة إلى هذا ، فإمكاني أن أعتقد حينئذ أننا قد وصلنا إلى نتيجة , سأقوم بإرسالها إلى مجلس إدارتنا صباح غد .
يلزم نلتجؤو للتصويت؟ إذا لا، نظن إنو توصلنا لاتفاق، واللي بش نبعثه لمجلس إدارتنا من غدوة الصباح.	هل نحتاج إلى طرح هذا للتصويت ؟ إن لم نكن في حاجة إلى هذا ، فإمكاني أن أعتقد حينئذ أننا قد وصلنا إلى نتيجة , سأقوم بإرسالها إلى مجلس إدارتنا صباح غد .
صباح الخير. رقدت بالباهي؟	صباح الخير . هل استرحت في نومك ؟
صباح الخير. رقدت بالقدا؟	صباح الخير . هل استرحت في نومك ؟
شباش تعمل كيف تكمل المدرسة؟	ماذا تنوي أن تفعل عقب الانتهاء من المدرسة . ؟
شنيا ناوي تعمل وقت ما تكمل قرايتك؟	ماذا تنوي أن تفعل عقب الانتهاء من المدرسة . ؟
سرقولي الساك في الشارع.	سرقت حقيبتي في الشارع .
سرقولي الصاكمان متاعي في الطريق.	سرقت حقيبتي في الشارع .
طلبت حاجة اخرى اليوم بخلاف فطور الصباح في الصباح؟	هل كان لديك أية خدمات أخرى إلى جانب طعام الإفطار هذا الصباح ؟
نحب قهوة بالحليب، يعيشك.	من فضلك ، أريد فنجاناً من القهوة البيضاء .
نتمنى ما تكونش تاعب برشا.	أتمنى ألا تكون متعبا جدا .
نحب نكري كرهبة من المودال هذا على نهارين.	أبغي تأجير سيارة من هذا الطراز لمدة يومين .
نحب كويس جاك دانيالز.	سآخذ صورة لجاك دانيلز .
تو ناخو كاس جاك دانيال.	سآخذ صورة لجاك دانيلز .
نحب شكارة قتانيا، يعيشك.	أريد كيساً من الفشار ، من فضلك .
نحب شكارة قطانيا، يعيشك.	أريد كيساً من الفشار ، من فضلك .
ضيعت عصا التزحليق.	سقط مني واحدا من عصى التزلج .
ضيعت عصا متاع السكي.	سقط مني واحدا من عصى التزلج .
مناش باش نهزو حتى كادو في الاستقبال. ع البلاصة، المستدعين يعطيو الفلوس.	نحن لا نجلب أية هدايا إلى الحفل ، وبدلا من ذلك يحضر الضيوف أموالاً نقدية .
نحب نبعثه بالبريد البري او البحري.	أود أن أرسله عن طريق البريد .
نحب نبعثه عن طريق البريد البري او البحري.	أود أن أرسله عن طريق البريد .
الطيارة باش توصل امخر حيت فما عاصفة ثلجية.	وصلت الطائرة متأخرة بسبب الثلج الكثيف .
الطيارة وصلت مخر بسبب العاصفة القوية متاع الثلج.	وصلت الطائرة متأخرة بسبب الثلج الكثيف .
نقص، يعيشك.	الفاتورة من فضلك ؟
قصان، يعيشك.	الفاتورة من فضلك ؟
ياخي تنجم تاخو الميساج، يعيشك؟	من فضلك هل يمكنك أن تتلقى رسالة ؟
سامحني، مانجمتش نتبعك. تنجم تتكلم اكثر بالشوية، يعيشك؟	آسف ، لا يمكنني متابعتك . هل من الممكن أن تتحدث ببطء أكثر من فضلك .
سامحني، ما نجمتش نتبعك. تنجمع تتكلم بالشوية بالشوية، يعيشك؟	آسف ، لا يمكنني متابعتك . هل من الممكن أن تتحدث ببطء أكثر من فضلك .
منين ناخذ تصاور؟	هل يمكنني أن التقط بعض الصور ؟
نجم نعمل تصاور؟	هل يمكنني أن التقط بعض الصور ؟
على مية.	من مائة .
على ميا.	من مائة .
انجم ناخذ نفس الماكلة؟	هل بإمكاني الحصول على طبق آخر مثل هذا ؟
نجم ناخو نفس البلا هذا؟	هل بإمكاني الحصول على طبق آخر مثل هذا ؟
بالله جيبلي فطور الصباح لبيتي السبعة متاع الصباح.	من فضلك ، احضر طعام الإفطار إلى غرفتي في السابعة من صباح الغد .
يعيشك جيبلي فطور الصباح لبيتي مع السبعا غدوة الصباح.	من فضلك ، احضر طعام الإفطار إلى غرفتي في السابعة من صباح الغد .
الصلاح باش يجي بعد شوية.	عامل الصيانة سيصعد في الحال .
تكنيسيان التصليح باش يطلع بعد شوية.	عامل الصيانة سيصعد في الحال .
مازالو فمة بلايص للجولة متاع نهار الخميس؟	هل هناك أماكن شاغرة بالنسبة لرحلة الخميس ؟
مازالو بلايص لجولة نهار الخميس؟	هل هناك أماكن شاغرة بالنسبة لرحلة الخميس ؟
سامحني. نجم نتعدى؟	عفواً . هلا سمحت لي بالمرور ؟
عندك نبتات وغلة؟	هل لديك أية نباتات أو فواكه ؟
بالله قلي كيفاش نعمر كارطة الهبوط؟	من فضلك أخبرني كيف أملأ بطاقة النزول إلى البر ؟
يعيشك قلي كيفاش نعمر بطاقة الهبوط؟	من فضلك أخبرني كيف أملأ بطاقة النزول إلى البر ؟
هذه ماكلة ما فيهاش كالوري؟	هل هذا الطعام منخفض السعرات الحرارية ؟
ياخي هذي ماكلة مافيهاش سعرات؟	هل هذا الطعام منخفض السعرات الحرارية ؟
شنيا الكار إلي يلزمني ناخوها باش نمشي للمحطة؟	أية حافلة يجب أن آخذ إلى المحطة ؟
ايه، هو. اما لازمك ادور على الليسار مع ثالث ضؤ واقعد في الثنية هذه لين توصل للثنية نومرو ستة و ستين.	نعم , إنه هو . ولكن ستضطر إلى الدوران يسارا في إشارة المرور الثالثة وتستمر في ذلك الشارع حتى تصل إلى الطريق رقم ستة وستين .
إيه. أما يلزمك تدور عل ليسار في الضوء الثالث وتبقى في النهج هذا حتى الطريق ست وستين.	نعم , إنه هو . ولكن ستضطر إلى الدوران يسارا في إشارة المرور الثالثة وتستمر في ذلك الشارع حتى تصل إلى الطريق رقم ستة وستين .
نرالك بالجميل إذا تهزني للبحر.	أكون ممتنا جدا لو أخذتني إلى الشاطئ .
سامحني . صارت غلطة. معاك تاناشا برس.	آسف . لقد اتصلت بالرقم الخطأ . هذه وكالة تانكيوشا الصحفية .
سامحني. النومرو هذا غالط. هذا تانكوشا برس.	آسف . لقد اتصلت بالرقم الخطأ . هذه وكالة تانكيوشا الصحفية .
باش نمشيو.	إننا سندفع الحساب ونغادر .
نقيدوا خروج.	إننا سندفع الحساب ونغادر .
النوع هذا موجود في الثمنية و عشرين، واحد و ثلاثين و خمسة و ثلاثين صانتيماتر.	هذا الموديل متوفر بمقاسات ثمانية وعشرين , وواحد وثلاثين وخمسة وثلاثين سنتيمترا .
الستيل هذا موجود في الثمانيا وعشرين، الواحد وثلاثين والخمسا وتلاثين صنتمتر.	هذا الموديل متوفر بمقاسات ثمانية وعشرين , وواحد وثلاثين وخمسة وثلاثين سنتيمترا .
اوه، يشبهلي بارشا.	أوه , يبدو كأنه قرعة .
انجم نستعمل تاليفونك، يعيشك؟	هل يمكن أن أستعمل هاتفك ؟
نجم نستعمل تاليفونك، يعيشك؟	هل يمكن أن أستعمل هاتفك ؟
نحب ناكد رحلتي لشيكاغو نهار سبعطاش.	أريد أن أعيد التأكيد على رحلتي إلى شيكاغو في السابع عشر .
نحب نعاود نأكد رحلتي لشيكاغو نهار سبعطاش.	أريد أن أعيد التأكيد على رحلتي إلى شيكاغو في السابع عشر .
كليت نوعا ما برشا.	أكلت كثيرا نوعا ما .
انجم نحكي مع سي براون؟	هل يمكن أن أتحدث إلى السيدة براون ؟
لازمها تكون مرتاحة باش تسكن في الدار هذه، موش هكا؟	هذا البيت يبدو مريحا للمعيشة فيه , أليس كذلك ؟
يلزم تكون مريحة برشا باش تعيش في ها البيت، صحيح؟	هذا البيت يبدو مريحا للمعيشة فيه , أليس كذلك ؟
سطوشي، باسبوري و حوايج متاعي اخرين.	محفظتي , جواز السفر ومتعلقات شخصية أخرى .
صطوش أوراقي، باسبوري وحاجات أخرى خاصة.	محفظتي , جواز السفر ومتعلقات شخصية أخرى .
وقتاش تسكروا؟	متى تغلقون ؟
وقتاش تسكر؟	متى تغلقون ؟
هذا بالضبط شنو قلت.	هذا بالضبط ما كنت سأقوله .
هذا بالضبط إلي كنت باش نقولو.	هذا بالضبط ما كنت سأقوله .
ايه، حتى انا نتصور هكا.	نعم , أعتقد ذلك .
إيه، نظنو زاد.	نعم , أعتقد ذلك .
دارك كبيرة، قداش من بيت؟	منزلك كبير . كم عدد الغرف ؟
دارك كبيرة، قداش فيها من بيت؟	منزلك كبير . كم عدد الغرف ؟
عجبنا العشاء.	استمتعنا بالعشاء .
عجبنا العشاء.	استمتعنا بالعشاء .
اه ايه، يعيشك. نتمنى متجيهمش دوخة بالبحر.	أوو ، نعم ، من فضلك . أنا أتمنى أن لا يصابوا بدوار البحر .
في اما وقت باش نوصلوا؟	ما هو موعد وصولنا المقدر ؟
شنيا الوقت المتوقع لوصولنا؟	ما هو موعد وصولنا المقدر ؟
باش نخرج بكري غدوة الصباح، هاكا علاش نحب نخلص توة.	سأغادر باكراً غداً ، لذلك أود أن أدفع الآن .
باش نخرج بكري غدوة الصباح، مالا ماضبيا نخلص توا.	سأغادر باكراً غداً ، لذلك أود أن أدفع الآن .
لاهي توة.	هو مشغول الآن .
هو مشغول في اللحظة هذي.	هو مشغول الآن .
البرانيين ينجموا ياخذوا كتب من المكتبة؟	هل الأجانب يمكنهم الحصول على الكتب في المكتبة ؟
لجانب عندهم الحق في الكتب في المكتبة هاذي؟	هل الأجانب يمكنهم الحصول على الكتب في المكتبة ؟
انجم نقعد في بيتي للساعتين متاع القايلة؟	هل من الممكن أن أمكث في غرفتي حتى الثانية مساءً ؟
ياخي نجم نبقى في بيتي حتى الماضي ساعتين متاع القايلة؟	هل من الممكن أن أمكث في غرفتي حتى الثانية مساءً ؟
اه، اه. نهارك زين في وقته. متفاهمين.	ها-ها . صباح الخير حان دورك . إنه على ما يرام .
آه، آه. نهارك زين من توا. متفقين.	ها-ها . صباح الخير حان دورك . إنه على ما يرام .
نحب فيلم متاع نومرو ال ايه اس ايه هذا للمصورة هذه، يعيشك.	أود بعضاً من فيلم رقم ايه إس ايه لهذه الكاميرا ، من فضلك .
نحب فيلم متاع رقم ال إيه اس إيه هاذا للمصورة هذي، يعيشك.	أود بعضاً من فيلم رقم ايه إس ايه لهذه الكاميرا ، من فضلك .
وين نلقى تصاور مونيه؟	أين رسومات مونيت ؟
وين موجودين طابلوات موني؟	أين رسومات مونيت ؟
البيتزا هذه فاوحة، شكون عملها؟	البيتزا لذيذة . من صنعها ؟
البيتزا هاذي بنينة، شكون طيبها؟	البيتزا لذيذة . من صنعها ؟
شنيا طعمة ها البلا؟	ما هو طعم هذا الطبق ؟
حتى هوما زادة غاليين.	هم أيضاً غاليين .
هوما زاد غالين برشا.	هم أيضاً غاليين .
وقتاش يخرج الترينو إلي من بعد لبوسطن؟	متى يغادر القطار التالي إلى بوسطن ؟
ملا راكب موج هايل.	يا له من راكب ماهر للأمواج .
ملا راكب موج تحفون.	يا له من راكب ماهر للأمواج .
سامحني اليدين قصار بارشا.	أخشى أن تكون الأكمام قصيرة جدا .
سامحني اليدين قصار برشا.	أخشى أن تكون الأكمام قصيرة جدا .
تنجم توريني كيفاش تحط الليسونس؟	هل يمكنك أن تريني كيف أضع الغاز ؟
تنجم توريني كيفاش تحط المازوت؟	هل يمكنك أن تريني كيف أضع الغاز ؟
سوم الوتيل داخل فيه فطور الصباح؟	هل أجرة الفندق تضم الإفطار ؟
سوم لوتيل فيه فطور الصباح؟	هل أجرة الفندق تضم الإفطار ؟
هذا كل شيء؟	هل هذا كل شيء ؟
هذا كل شي؟	هل هذا كل شيء ؟
هو في آخر الطريق هذا.	إنه في نهاية هذا الطريق .
بالله حطلي العداد يمشي.	من فضلك ابدأ العداد .
يعيشك خدم العداد.	من فضلك ابدأ العداد .
الدنيا باردا بارشا في بيتي.	غرفتي أبرد من اللازم .
بيتي باردة برشا.	غرفتي أبرد من اللازم .
تو نكون معاك كيف ما نكونش لاهي.	سأعود إليك عندما تكون أقل انشغالاً .
نحس بروحي ابرك.	أشعر بتحسن .
نحس في روحي خير.	أشعر بتحسن .
بالله وريني انا وين في الخريطة.	من فضلك أرني أين أنا على هذه الخريطة .
يعيشك وريني وين أنا موجود على الخريطة هاذي.	من فضلك أرني أين أنا على هذه الخريطة .
مية بالمية قطن.	مائة بالمائة قطن .
ميا بالميا قطن.	مائة بالمائة قطن .
نحب نبدلها ببيت تطل على الواد. فما زيادة؟	أود أن أغير لغرفة تطل على المحيط . هل توجد أي رسوم إضافية ؟
نهار عشرة نوفمبر.	العاشر من نوفمبر .
عشرا نوفمبر.	العاشر من نوفمبر .
فيه بارشا مطعم.	إنها لذيذة جداً .
هذا عندو برشا ذوق.	إنها لذيذة جداً .
وقتاش باش هطيروا؟	متى سنقلع ؟
كيفاش تعلم الشيفور إنو تحب تهبط؟	كيف عرفت السائق متى تريد أن تنزل ؟
اربعة و عشرين دولار. تحب اكثر؟	أربعة وعشرين دولاراً . هل تريد المزيد ؟
أربعا وعشرين دولار. تحب أكثر؟	أربعة وعشرين دولاراً . هل تريد المزيد ؟
عملت الحجز كطوكيو تو عندي شهر.	عملت الحجز في طوكيو منذ شهر .
عملت الحجز لطوكيو توا شهر.	عملت الحجز في طوكيو منذ شهر .
نشكر من اعماق قلبي.	أشكرك من أعماق قلبي .
نشكرك من أعماق قلبي.	أشكرك من أعماق قلبي .
لازمني نهبط من هوني باش نمشي لمركز روكفلر؟	هل أنزل هنا لمركز روكفيلر ؟
يلزمني نهبط هوني باش نمشي لروكفلر سنتر؟	هل أنزل هنا لمركز روكفيلر ؟
بالله قيس صدري.	من فضلك قس حجم حذائي .
يعيشك خوذ قياسي.	من فضلك قس حجم حذائي .
هايل بارشا.	إنها رائعة .
هذا رايع.	إنها رائعة .
تحب تخرج معايا؟	هل ستحدد موعداً للخروج معي ؟
تحب تخرج معايا؟	هل ستحدد موعداً للخروج معي ؟
بالله نضفلي الكبوط.	من فضلك نظف هذا المعطف .
يعيشك أغسل الكبوط هذا.	من فضلك نظف هذا المعطف .
نحب نكري فلوكة بالموتور.	أود أن أؤجر قارب بمحرك .
نحب نكري باطو بموتور.	أود أن أؤجر قارب بمحرك .
وين تجي بلاصة دبش النساء؟	أين قسم السيدات ؟
وين موجودة لبسة النسا؟	أين قسم السيدات ؟
القهوة ما هياش داخلة؟	القهوة غير محسوبة .
القهوة موش محسوبة؟	القهوة غير محسوبة .
في اما موضوع كان الاول؟	في أي مجال كان من قبل ؟
في أنا دومان كان قبل؟	في أي مجال كان من قبل ؟
لازمني نزيد ندفع فلوس باش ندخل للبنية؟	هل يجب أن أدفع الرسم الإضافي عندما أدخل مبنى ؟
الضربة توجع.	جرحي يؤلمني .
جرحي يوجع فيا.	جرحي يؤلمني .
وين المحطة؟	أين المحطة ؟
ويني المحطة؟	أين المحطة ؟
عندي الرعدة.	عندي قشعريرة .
ثلاثة ايام.	ثلاثة أيام .
تلاثا أيام.	ثلاثة أيام .
منحبهاش اتعب.	لا أريد واحدة ضخمة .
ما نحبش واحد كبير.	لا أريد واحدة ضخمة .
فما توخير صغير.	سيكون هناك تأخير بسيط .
باش يكون فما شوية تأخير.	سيكون هناك تأخير بسيط .
شنوة الفرق بين الوتلا هاذم؟	ما هي الفوارق بين هذه الفنادق ؟
شنيا الفرق بين الوتلا هاذم؟	ما هي الفوارق بين هذه الفنادق ؟
كان هايل. يعيشك.	كان عظيماً . شكراً .
عندكشي حاجة اطول شوية؟	هل لديك أي شيء لفترة أطول قليلاً ؟
عندك حاجة ما أطول شوية؟	هل لديك أي شيء لفترة أطول قليلاً ؟
تاريخ الانتهاء مارس الف و تسعمية و تسعة و تسعين.	تاريخ الانتهاء تسعة عشر من مارس تسعة وتسعين .
تاريخ الانتهاء مارس ألف وتسعا ميا وتسعا وتسعين.	تاريخ الانتهاء تسعة عشر من مارس تسعة وتسعين .
فما بلايص قمار سماح؟	هل توجد أية كازينوهات جيدة ؟
فما ملاهي باهية؟	هل توجد أية كازينوهات جيدة ؟
اهم الفلوس لستيلو الحبار. ورقة بو مية دولار.	هذه هي فلوس أقلام الحبر . فاتورة بمائة دولار .
هاك حق الستيلوات الجافة. ورقة بميات دولار.	هذه هي فلوس أقلام الحبر . فاتورة بمائة دولار .
وين تجي بلاصة دبش النساء؟	أين قسم السيدات ؟
وين موجودة لبسة النسا؟	أين قسم السيدات ؟
منين نطلع؟	أين يمكن أن أركب القارب ؟
وين نجم نطلع؟	أين يمكن أن أركب القارب ؟
صاحبي مضروب.	صديقي مصاب .
صاحبي تضرب.	صديقي مصاب .
خرجت عليك.	تبدو بصحة جيدة .
هذا يواتيك بالقدا.	تبدو بصحة جيدة .
ياخي تنجم تقلملي شلاغمي؟	هل يمكنك أن تشذب شاربي ؟
ما نجمش نبيعلك هذا بلاش وصفة طبية.	لا يمكن أن أبيع هذه دون روشتة .
نجم نحجز خمسا بلايص في نفس الصف؟	هل يمكن أن أحجز خمسة مقاعد في الصف نفسه .
اماهي الكرهبة الي ما تاكلش ايسونس؟	أي سيارة ذات أداء أفضل ؟
أناهي الكرهبة لقتصادية أكثر؟	أي سيارة ذات أداء أفضل ؟
معندكش تخفيض، من غير ما تلح.	لن تأخذ خصماً مهما حاولت .
تنجم تحل الصاك هذا، يعيشك؟ شنيا عندك في وسطو؟	هلا فتحت هذه الحقيبة ، من فضلك ؟ ماذا يوجد هنا .
نحب نعمل تاليفون لبلاصة بعيدة للوتيل هيلتون في بوسطن.	أريد أن أعمل مكالمة مسافة طويلة إلى فندق هيلتون في بوسطن .
نحب نعمل تاليفون لمسافة طويلة لوتيل هيلتون في بوسطن.	أريد أن أعمل مكالمة مسافة طويلة إلى فندق هيلتون في بوسطن .
رد بالك، السقف واطي.	كن حذراً ، السقف منخفض .
رد بالك، السقوفات واطين.	كن حذراً ، السقف منخفض .
مانشوفش في الايكران بالباهي من هوني. انجم نبدل بلاصتي؟	لا أستطيع رؤية الشاشة جيداً من هنا ، هل يمكنني تبديل المقاعد لبعض الوقت ؟
ما نشوفش في ليكران بالقدا من هوني. نجم نبدل البلاصة للحظة؟	لا أستطيع رؤية الشاشة جيداً من هنا ، هل يمكنني تبديل المقاعد لبعض الوقت ؟
زرت البحيرات العظمى لأول مرة.	لقد قمت بزيارة البحيرات الكبرى لأول مرة .
فما مشكل مع الماكينة متاع الفلوس.	ثمة شئ خطأ في آلة التهوية هذه .
فما مشكلة في الموزع الآلي.	ثمة شئ خطأ في آلة التهوية هذه .
لازمني نشوف طبيب.	أحتاج إلى طيب .
يلزمني نشوف طبيب.	أحتاج إلى طيب .
قداش عدات من مدة في المملكة المتحدة؟	كم المدة التي قضتها هي حتى الآن في المملكة المتحدة ؟
قداش قعدت في المملكة المتحدة؟	كم المدة التي قضتها هي حتى الآن في المملكة المتحدة ؟
محب للفن الجديد كيفك يحب الرسوم ديال الهيبي و موسيقى الشارع.	من المرجح أن محبا للإبداع الفني مثلك سيستمتع اللوحات الزيتية غير التقليدية وعروض الموسيقى بالشوارع .
محب للفنون الجديدة كيفك إنت باش يقدر من غير شك اللوحات من ستيل الهيبي وجو موزيكة الشارع.	من المرجح أن محبا للإبداع الفني مثلك سيستمتع اللوحات الزيتية غير التقليدية وعروض الموسيقى بالشوارع .
تشوف في بنية بيضا، صحيح؟ هو مقابل البنية هاذي.	يمكنك رؤية مبنى ابيض اللون ، أليس كذلك ؟ إنه أمام ذلك المبنى .
اليابانيين ما ياخذوش عطلة طويلة.	اليابانيون لا يأخذون إجازات طويلة .
اليابانيين ما ياخذوش عطل طويلة.	اليابانيون لا يأخذون إجازات طويلة .
نحس بروحي تحت العينين. موش ديما نارى ياباني؟	اشعر كأن هناك تحديق في . هل من النادر رؤية شخص ياباني ؟
عندي شعور بإني ملاحق. هذا قليل برشا إنو تشوف ياياني؟	اشعر كأن هناك تحديق في . هل من النادر رؤية شخص ياباني ؟
وين يجي مدخل البوستا الكبيرة؟	أي طريق يؤدي إلى مكتب البريد المركزي ؟
في أنا إتجاه موجود مدخل البوسطة المركزية؟	أي طريق يؤدي إلى مكتب البريد المركزي ؟
وين تجي محطة غرايهوند في البلاد هذه؟	أين محطة أتوبيس جرايهاوند في هذه البلدة ؟
وين موجودة محطة الكيران غرايهوند في المدينة هاذي؟	أين محطة أتوبيس جرايهاوند في هذه البلدة ؟
نتصوره قوي شوية علية.	اعتقد أن هذا عالي قليلا بالنسبة لي .
نظن هو قوي شويا عليا.	اعتقد أن هذا عالي قليلا بالنسبة لي .
نحب السوم المشكور.	أريد سعر الكتاب .
منين ناخذ تسكرة للميترو؟	أين يمكنني شراء تذكرة للمترو ؟
وين نجم نشري تسكرة مترو؟	أين يمكنني شراء تذكرة للمترو ؟
عندي بلايص درجة اعمال، موش هكا؟	سآخذ مقاعد درجة رجال أعمال ، أليس كذلك ؟
باش تكون عندي بلايص في درجة الأعمال، هذا هو؟	سآخذ مقاعد درجة رجال أعمال ، أليس كذلك ؟
بقداش خلاص التكسي من اللوتيل لمحطة الترينو؟	كم أجرة التاكسي من هذا الفندق إلى المحطة ؟
قداش سوم كورسة بالتاكسي بين اللوتيل هذا ولقار؟	كم أجرة التاكسي من هذا الفندق إلى المحطة ؟
انجم ناخذ هذا و هذا، يعيشك؟	هل لي بهذه وهذه ، من فضلك ؟
نجم ناخو هذا وهذا، يعيشك؟	هل لي بهذه وهذه ، من فضلك ؟
يقولو إلي اليابان بلاد غنية برشا.	يقولون أن اليابان دولة غنية جداً .
فما بيوت فاضية في الكراهب متاع النومان؟	هل هناك أي غرف خالية في عربة النوم ؟
هدية لواحد صاحبي.	هذه هديه لصديق .
هاذي هدية لصاحب.	هذه هديه لصديق .
الثلج رجع الثنية تتزحلق.	الثلج يجعل الطريق زلق .
الثلج رد الطريق يزلق.	الثلج يجعل الطريق زلق .
ما لقيتش مصورتي.	لا أستطيع أن أجد كاميرتي .
عندك حاجة باش تخبر عليها؟	هل لديك أي شئ لإعلانه ؟
عندك أي حاجة تصرح بيها؟	هل لديك أي شئ لإعلانه ؟
ريت كبوت ازرق؟ حطيته على الكرسي.	هل رأيت معطف أزرق ؟ وضعته على هذا الكرسي .
جيت من طوكيو.	أنا من طوكيو .
أنا من طوكيو.	أنا من طوكيو .
نحب على تراتمون ريفلون.	أريد بعض الغسول لإزالة كريم ريفلون .
عندي شوية حوايج للغسيل.	لدي بعض الملابس للمغسلة .
عندي حوايج للغسيل.	لدي بعض الملابس للمغسلة .
ناخذ شكلاطة سخونة.	سآخذ شيكولاتة ساخنة .
نجمو نرتبو باش نظفو بيتك.	نستطيع أن نرتب لتنظيف غرفاتكم .
خاص، يعيشك.	خاص من فضلك .
بقداش حتى للوتيل سي؟	كم تكلفة الذهاب إلى فندق سي ؟
بقداش حتى للوتيل سي؟	كم تكلفة الذهاب إلى فندق سي ؟
نحب نعمل حجز لطاولة من الساعتين لتسعة متاع الليل، يعيشك.	أود حجز مائدة لفردين في الساعة السابعة , من فضلك .
نحب نحجز طاولة لربعطاش واحد مع السبعا متاع العشية، يعيشك.	أود حجز مائدة لفردين في الساعة السابعة , من فضلك .
نحب على بوماضة متاع ليل.	أريد بعض الكريم الليلي .
تنجم تغلفهولي بغلاف هدية؟	هل لك أن تغلف هذه كالهدية ؟
توة الثلاثة و ربع.	إنها الثالثة والربع .
توا ماضي تلاثا وربع متاع الصباح.	إنها الثالثة والربع .
ناوي نبعث فاتورات مصاريفي الأساسية، مالا يعيشك أعطيني عنوان وإسم الشخص المسؤول.	سأخطط لإرسال فواتير حاجياتي اليومية ، لذا من فضلك أخبرني العنوان و اسم الشخص المسئول من فضلك .
عندك منها هذه في نفس النوع بكعب اعلى؟	هل لديك نفس هذا التصميم بكعب أعلى ؟
عندك هاذم في نفس الموديل مع قدم أعلى؟	هل لديك نفس هذا التصميم بكعب أعلى ؟
نحب تريكو لوليد عمره عشرة سنين.	أريد جاكيت لطفل في العاشرة من العمر .
هزنا لثنية ابباي، يعيشك.	خذني إلى طريق أباي , من فضلك .
هزني لآبي رود، يعيشك.	خذني إلى طريق أباي , من فضلك .
انا متاكد كوني حجزت.	أنا متأكد أن لدى حجز .
أنا متأكد إني حجزت.	أنا متأكد أن لدى حجز .
تو نبعثهالك، كان تحب استنى هوني.	سأرسلها لك ، لذا من فضلك انتظر هنا .
تو نبعثهولك، إذا تحب إستنى هوني.	سأرسلها لك ، لذا من فضلك انتظر هنا .
عندي وجيعة صغيرة في راسي.	أشعر بصداع خفيف .
عندي وجيعة خفيفة في راسي.	أشعر بصداع خفيف .
عجبني بارشا الفطور.	لقد استمتعت بالوجبة كثيراً جداً .
تنجم تسطرلي خريطة، يعيشك؟	هل لك أن ترسم لي خريطة , من فضلك ؟
تنجم تصورلي خريطة، يعيشك؟	هل لك أن ترسم لي خريطة , من فضلك ؟
تعرضت للسرقة في شط وايمانالو. ايجا توة، يعيشك.	لقد سرقت في شاطئ وايمانالو . من فضلك تعالى فوراً .
تعرضت للإعتداء في ويمانالو بيتش. إيجا توا يعيشك.	لقد سرقت في شاطئ وايمانالو . من فضلك تعالى فوراً .
شنوة تقول بمية دولار؟	ماذا عن مائة دولار ؟
شنيا رايك في ميات دولار؟	ماذا عن مائة دولار ؟
نحبها مغلفة.	أريد هذا معبئاً .
نحبو مغلف.	أريد هذا معبئاً .
نحب نعاود كارطتي.	أريد أن أقدم طلباً للحصول على إصدار جديد .
نحب نعمل تجديد لبيطاقتي.	أريد أن أقدم طلباً للحصول على إصدار جديد .
الحكومة تشجع الاستثمار في الصناعة.	لقد دعمت الحكومة تنمية الصناعات .
لحكومة دعمت تنمية الصناعات.	لقد دعمت الحكومة تنمية الصناعات .
عنده اكثر من الخمسين سنة.	أعتقد أن عمره أكثر من خمسين سنة .
عندك خرائط ساهلين للمدينة؟	هل لديك أيّ خرائط بسيطة للمدينة ؟
عندك خرايط بسيطة للمدينة؟	هل لديك أيّ خرائط بسيطة للمدينة ؟
مع شلوقت الترينو يوصل لسان دييغو، يعيشك؟	متى سيصل القطار إلى سان دييجو ، من فضلك ؟
في أنا ساعة باش يوصل التران لسان دياغو، يعيشك؟	متى سيصل القطار إلى سان دييجو ، من فضلك ؟
نحب نعمل نضرة على مقصورتك.	آوه إلقاء نظرة على صندوقك .
نحب على الشامبوان.	أريد بعض الشامبو .
نحب على شامبوا.	أريد بعض الشامبو .
وصلت لوتيل هيلتون.	أنا أقيم في فندق هيلتون .
أنا قعدت في وتيل هيلتون.	أنا أقيم في فندق هيلتون .
أنا نحس في روحي موش لاباس وعندي دوخة.	أشعر بحالة سيئة وغثيان .
اما عندي موعد معاها مع الساعتين.	لكنّي لدى موعد لرؤيتها في السّاعة الثّانية .
أما عندي موعد معاها مع ماضي ساعتين متاع العشية.	لكنّي لدى موعد لرؤيتها في السّاعة الثّانية .
الكرهبة هذه ماشيا لادنبرة؟	هل تذهب هذه السيارة إلى إدنبرة ؟
الكرهبة هاذي ماشية لإدنبرة؟	هل تذهب هذه السيارة إلى إدنبرة ؟
ايه بالله عمر هذا المطلب.	نعم ، رجاءً املأ هذه الاستمارة .
إيه، يعيشك عمر المطبوعة هاذي.	نعم ، رجاءً املأ هذه الاستمارة .
شنوة الزيادة على الباقاج الزايد؟	ما هو مقدار الرسوم للوزن الزائد ؟
قداش الزيادة للدبش الزايد؟	ما هو مقدار الرسوم للوزن الزائد ؟
في اما وقت انجم نخرج؟	في أي وقت يمكنني مغادرة الفندق ؟
في أنا ساعة نجم نخرج؟	في أي وقت يمكنني مغادرة الفندق ؟
فهمت.	فهمت الأمر .
فهمت.	فهمت الأمر .
تو نكلم شكون.	سوف أطلب شخصاً ما .
الكرهبة جات مرة اخرى في المفترق.	السيارة جاءت لي من الجانب عند التقاطع .
الكرهبة وقفتلي على جنب في التقاطع.	السيارة جاءت لي من الجانب عند التقاطع .
هذه بواتا متاع موسيقى.	إنه صندوق موسيقى .
هذا صندوق موزيكا.	إنه صندوق موسيقى .
وين الاحياء؟	أين الضاحية ؟
وين الضاحية؟	أين الضاحية ؟
فما زيارة للمدينة بالكار؟	هل هناك جولة بالحافلة تجوب المدينة ؟
فما زيارة للمدينة بالكار؟	هل هناك جولة بالحافلة تجوب المدينة ؟
في اما وقت نبداو؟	في أي وقت نبدأ ؟
في أنا ساعة نبداو؟	في أي وقت نبدأ ؟
باهي، يا سيدي. قياس متوسط، نقترح عليك ماركيري سابل، مريقل؟	"حسنا ، يا سيدي . في الحجم المتوسط نعرض عليك فرو السمور من نوع "" ميركوري "" ، فهل ذلك يوافقك ؟"
باهي، موسيو. في قياس متوسط، نجمو نقترحو عليك الزئبق لسود، هذا يناسبك؟	"حسنا ، يا سيدي . في الحجم المتوسط نعرض عليك فرو السمور من نوع "" ميركوري "" ، فهل ذلك يوافقك ؟"
عندك تمطط في العضلات.	لقد تسببتّ في كَدْمة بالعَضَلة .
لازمك تخليني نشوت الكورة، موش انا، باهي؟	ولكن عليك أن تعدني بركل الكرة ، وليس أنا . موافق ؟
أما يلزمك توعدني باش نضرب الكرة، موش أنا، باهي؟	ولكن عليك أن تعدني بركل الكرة ، وليس أنا . موافق ؟
على قداش المسافة؟	إلى أي مسافة يبعد أكثر ؟
منين ناخذ الماكينة؟	هل لي في استعارة بعض البياضات ؟
نجم نتسلف حوايج؟	هل لي في استعارة بعض البياضات ؟
من اما نوع جلد تصنعت الفاليز؟	من أي نوع من الجلد الصناعي صُنعت حقيبة السفر هذه ؟
من أنا نوع من الجلد مصنوعة الفاليجة هاذي؟	من أي نوع من الجلد الصناعي صُنعت حقيبة السفر هذه ؟
ضاهرلي الموس هذا موش نضيف. تنجم تعطني واحد اخر؟	لا أعتقد أن هذه السكينة نظيفة . أيمكنك أن تُحضر لي واحدة أخرى ؟
ما نظنش إنو السكينة هاذي تكون نظيفة. تنجم تعطيني واحدة أخرى؟	لا أعتقد أن هذه السكينة نظيفة . أيمكنك أن تُحضر لي واحدة أخرى ؟
شريت هذا من مدة، أما ياخي تنجم تبدلو بهذا؟	لقد اشتريت هذه من لحظة ، ولكن هلاً بدلت هذه بتلك ؟
باش نكون واضح معاك، مانيش موافق.	بصراحة ، لا أتفق مع ذلك .
باش نكون صريح برشا، مانيش متفق مع هذا.	بصراحة ، لا أتفق مع ذلك .
هذه الثنية الصححة للمحطة الرسمية؟	هل هذا هو الطريق الصحيح إلى المحطة المركزية ؟
هاذي الثنية الصحيحة للمحطة المركزية؟	هل هذا هو الطريق الصحيح إلى المحطة المركزية ؟
بتو و معاه دليل، يعيشك.	قارب مع مرشد ، من فضلك .
باطو بالقيد، يعيشك.	قارب مع مرشد ، من فضلك .
نحب ناخذ كسوة لونها غامق ليلي.	أود أن أطلب بدلة داكنة من أجلي .
نحب نوصي كوستيم لونو غامق ليا أنا.	أود أن أطلب بدلة داكنة من أجلي .
السحابة هذه تقوم بالواجب كيما العكاز.	هذه المظلة يمكن استخدامها كعصا للسير .
السحابة هاذي تعوض العصا.	هذه المظلة يمكن استخدامها كعصا للسير .
تنجم توريني جواز اللسفر متاعك، يعيشك.	من فضلك أرني جواز سفرك .
يعيشك وريني بسبورك، يعيشك.	من فضلك أرني جواز سفرك .
فماشي بلاصة تقبل الغسيل نهار الاحد؟	هل يوجد مكان يقبل تنظيف الملابس في أيام الآحاد ؟
زوز برغر بالجبن، يعيشك.	سندويتشان برجر بالجبن ، من فضلك .
أناهي الكار إلى تمشي لميامي؟	أية حافلة تذهب إلى ميامي ؟
حتا بوربوار ماهو لازم.	ولكن لا ضرورة لدفع بقشيش .
أما حتى بوربوار ماهو ضروري.	ولكن لا ضرورة لدفع بقشيش .
تنجم تورينا واحد في صالة كارنيجي.	"بمقدورك أن ترى واحداً عند "" كارينجي هول "" ."
تنجم تشوف واحد في صالة كارنيجي.	"بمقدورك أن ترى واحداً عند "" كارينجي هول "" ."
ما نيش موافق.	لستُ معتمداً قانونياً .
أنا مانيش معتمد.	لستُ معتمداً قانونياً .
شنية خاصية الدار؟	ما هو الصنف المميز للمحل ؟
شنيا إختصاص الدار؟	ما هو الصنف المميز للمحل ؟
نحب ناخو موعد مع طبيب.	أودّ حجز موعد مع طبيب .
نقلقك كان نجي بحذاك؟	أنت لا تمانع في حضوري إلى منزلك ؟
تقولشي عليه فما تقدم باش يتعمل.	يبدو أن ثمة مجالات للتحسينات .
وين موجود الميترو؟	أين مترو الأنفاق ؟
وين موجود المترو؟	أين مترو الأنفاق ؟
عندكمشي قياس ما أصغر؟	هل عندكم منه بحجم أصغر ؟
عندك قياس ما أصغر؟	هل عندكم منه بحجم أصغر ؟
وين نلقا دواء الراس؟	أين يمكنني الحصول على أسبرين ؟
وين نجم نلقى لسبيرين؟	أين يمكنني الحصول على أسبرين ؟
ياخي بالسوم لرخص؟	ذلك الحد الأدنى للسعر .
بالله اعطيني كارطة بجمعة.	من فضلك اعطني تصريحاً سارياً لمدة أسبوع .
يعيشك أعطيني بطاقة الجمعة.	من فضلك اعطني تصريحاً سارياً لمدة أسبوع .
هذا زميلي.	هذا زميلي .
اهو واحد.	هنا واحد .
شوف هذا واحد.	هنا واحد .
باش نلقط قريب.	أنا مقبل على الإصابة بنوبة برد .
باش يصيبني برد.	أنا مقبل على الإصابة بنوبة برد .
حنش بحر مشوي و معاه صالصة بالروز.	إنه سمك ثعبان مشوي مع مرقة خاصة فوق سلطانية من الأرز .
هذا أنقليس مشوي مع صوص خاصة فوق صحن متاع روز.	إنه سمك ثعبان مشوي مع مرقة خاصة فوق سلطانية من الأرز .
"قلي ""نحتفلو بهذا"" و هزني لبار. قلي باش يعمل نضرة و روح من غير ما يرجع و خلاني واحل بفاتورة غالية."	دعونا نحتفل  ، هكذا قال وآخذني إلى بار . وقال إنه سيُجري مكالمة هاتفية وغادر ولم يعد أبداً وتحملت أنا وحدي عبء فاتورة ضخمة .
"قالي ""نحتفلو بهذا"" وهزني لبار. قال إنو ماشي يعمل في تاليفون وخرج من غير ما رجع جملة ولقيت روحي متكونسيا قدام فاتورة غالية برشا."	دعونا نحتفل  ، هكذا قال وآخذني إلى بار . وقال إنه سيُجري مكالمة هاتفية وغادر ولم يعد أبداً وتحملت أنا وحدي عبء فاتورة ضخمة .
بقداش الجالون الواحد؟	كم تكلّف هي لكل جالون ؟
عندي جواز السفر و كارطة البانكا.	كان معي جواز سفري وبطاقتي الائتمانية في جيبي .
كان عندي باسبوري والكارت كريدي متاعي في صاكي.	كان معي جواز سفري وبطاقتي الائتمانية في جيبي .
حجز للسبعة باسم مانو.	الحجوزات في السابعة ، تحت اسم مانو .
حجز لسبعا متاع الصباح بإسم مانو.	الحجوزات في السابعة ، تحت اسم مانو .
ما تحبش كويس تاي؟	ألا ترغب في فنجان شاي ؟
ما تحبش كاس تاي؟	ألا ترغب في فنجان شاي ؟
فماشي طبيب في اللوتيل ولا قاعد ديما؟	هل هناك طبيب للفندق أو واحد على صلة بالفندق .
ديما يعمل جرياته في شارع بوند.	"إنه يقوم دائماً بالتسوق في شارع "" بوند "" ."
جريدة انقليزية، يعيشك.	جريدة باللغة الإنجليزية ، لطفاً .
جريدة إنقليزية، يعيشك.	جريدة باللغة الإنجليزية ، لطفاً .
فماشي بلاصة وين نلعبوا الموسيقى الريفية؟	هل هناك مكان يتم فيه عزف الموسيقي الريفية ؟
فماشي وحيد اخرين صوف؟	أي منتجات صوفية أخرى ؟
فما أخرين بالصوف؟	أي منتجات صوفية أخرى ؟
بقداش لكل ورقة؟	كم تكلف الملاءة الواحدة ؟
بقداش ياخي للورقة؟	كم تكلف الملاءة الواحدة ؟
باهي، اعمل تسعة صفر واحد واحد، بعد نومرو البلاد و نومرو التاليفون.	حسنا ، اضغط تسعة وصفر واحد واحد ، ثم الكود الخاص بالبلد ورقم الهاتف .
باهي، أطلب تسعا صفر واحد واحد، بعد رمز البلاد ونومرو التاليفون.	حسنا ، اضغط تسعة وصفر واحد واحد ، ثم الكود الخاص بالبلد ورقم الهاتف .
انجم ناخذ كوكا كولا بلاش سكر؟	هل يمكن أن أحصل على كوكاكولا دايت ؟
نجم ناخو كوكا كولا لايت؟	هل يمكن أن أحصل على كوكاكولا دايت ؟
انجم نعدي المطلب؟	هل بإمكاني إجراء طلبية ؟
نجم نعدي كوموند؟	هل بإمكاني إجراء طلبية ؟
عملنا مشيا باهية. يعيشك.	استمتعنا بجولة لطيفة بالسيارة . شكراً لك .
الشعب الياباني يجي مية و ثلاثين مليون.	إجمالي سكان اليابان حوالي مائة وثلاثين مليوناً .
متساكنين اليابان الكل تقريب ميا وتلاثين مليون.	إجمالي سكان اليابان حوالي مائة وثلاثين مليوناً .
نحب نكري مظلة.	أود استئجار شمسية .
ايه، ونحب نتكلم علي حساب الي باش نكلمه.	أجل ، وأودّ محاسبة المطلوب هاتفياً على قيمة المكالمة .
إيه، ونحب نتكلم مكالمة عل حساب المتلقي.	أجل ، وأودّ محاسبة المطلوب هاتفياً على قيمة المكالمة .
سطوش معاه مية دلار و زوز كوارط بانكا.	محفظة بها مائة دولار وبطاقتان ائتمانيتان .
صطوش أوراق فيه ميات دولار وزوز كارت كريدي.	محفظة بها مائة دولار وبطاقتان ائتمانيتان .
الماء سخون بارشا.	الماء أسخن من اللازم .
انتم هوني.	أنت هنا .
إنت هوني.	أنت هنا .
بعيد بارشا.	غير محتمل بدرجة كبيرة .
مستبعد برشا.	غير محتمل بدرجة كبيرة .
عندي وجيعة في ماعدتي بعد الماكلة.	معدتي تؤلمني بعد الوجبات .
اوه، ملا بلاصة سمحة.	عظيم ، ذلك مكان لطيف .
واو، مالا بلاصة مزيانة.	عظيم ، ذلك مكان لطيف .
قال يمكن فما غاز مطين.	ربما كان يعاني سّدَّة تنفسية .
يمكن يكون عندو هواء محصور.	ربما كان يعاني سّدَّة تنفسية .
ايا قررتوا؟	هل قرّرتَ ؟
قررت؟	هل قرّرتَ ؟
كان تحب، انجموا نرتاحوا هوني.	إذا كنت تودّ ، بإمكاننا الاستراحة هنا .
إذا تحب، نجمو نرتاحو هوني.	إذا كنت تودّ ، بإمكاننا الاستراحة هنا .
موش ساهل تبدل الخدمة.	ليس بمقدورك تغيير وظيفتك بسهولة .
موش ساهل تبدل خدمتك.	ليس بمقدورك تغيير وظيفتك بسهولة .
شنية المحطة الجاية؟	ما هي المحطة التالية ؟
أناهي المحطة الجايا؟	ما هي المحطة التالية ؟
هايل، اما موش المدارج المعرية، اليومة نهار سخون.	حسنا ، ولكن ليس منطقة المقاعد المكشوفة . فاليوم شديد الحرارة .
باهي برشا، أما موش المدارج البرانية، الطقس اليوم سخون برشا.	حسنا ، ولكن ليس منطقة المقاعد المكشوفة . فاليوم شديد الحرارة .
نحس بروحي باش نرد.	مازلت أشعر بالرغبة في القيء .
حاسس باش نزيد نرد.	مازلت أشعر بالرغبة في القيء .
ما نحب حتى شيء كبير.	لا أريد أي شيء يكون كبير الحجم .
ثبت، يعيشك.	الحساب ، من فضلك .
ثبت، يعيشك.	الحساب ، من فضلك .
الفاتورة، يعيشك. تاخذو الكوارت فيزا؟	التكلفة ، من فضلك . هل تقبلون بطاقة فيزا ؟
اليوم، باش نمشي نارا شنوة يشبه الحي الصيني.	اليوم سأذهب لأرى كيف يبدو الحيّ الصين .
اليوم، باش نمشي نشوف شنيا يشبه الحي الصيني.	اليوم سأذهب لأرى كيف يبدو الحيّ الصين .
اثنين صفر اثنين تسعة ثلاثة تسعة ستة سبعة صفر صفر.	اثنان صفر اثنان تسعة ثلاثة تسعة ستة سبعة صفر صفر .
إثنين صفر إثنين تسعا تلاثا تسعا ستا سبعا صفر صفر.	اثنان صفر اثنان تسعة ثلاثة تسعة ستة سبعة صفر صفر .
نحب نقلع سناني.	أرغب في خلع أسناني .
نحب نقلع سنيا.	أرغب في خلع أسناني .
نحب صطوش ماكياج.	أرغب في حقيبة مستحضرات تجميل .
"وين انجم نشوف ""شبح الأوبرا""؟"	"أين يمكنني مشاهدة عَرْض "" شبح الأوبرا "" ؟"
"وين نجم نشوف ""شبح الأوبيرا""؟"	"أين يمكنني مشاهدة عَرْض "" شبح الأوبرا "" ؟"
نحب نشري هدية للذكرى لصحابي. باش تنصحني؟	أريد شراء تذكارات لأصدقائي . أيمكن أن تُوصي ببعض منها ؟
نحب نشري هدايا تذكارية لأصحابي. تنجم تنصحني؟	أريد شراء تذكارات لأصدقائي . أيمكن أن تُوصي ببعض منها ؟
بالشوية، يعيشك.	بطريقة أبطأ ، من فضلك .
بالشوية أكثر، يعيشك.	بطريقة أبطأ ، من فضلك .
مقلية من الشيرتين، يعيشك.	مقلية على الجانبين ، من فضلك .
باش يكون حاضر بعد- غدوة في السهرية.	سيكون جاهزا بعد غد في المساء .
مصنوع من القطن؟	هل هذا مصنوع من القطن ؟
ياخي مصنوع من القطن؟	هل هذا مصنوع من القطن ؟
شباش نشوف في هذه الرحلة؟	ما الذي يمكن أن أراه في هذه الجولة ؟
شنيا نجم نشوف في الجولة هاذي؟	ما الذي يمكن أن أراه في هذه الجولة ؟
ايه، على الاقل فما حاجة تتشرب.	نعم , يوجد مشروب على الأقل .
إيه، فما عل لقل مشروب واحد.	نعم , يوجد مشروب على الأقل .
بقداش النهار؟	ما تكلفة هذا في اليوم ؟
نحب سي دي.	أريد اسطوانة مدمجة .
فما رحلات الخطوط الجوية اليابانية وأول نيبون يخرجو الاحداش غير درج. اما الله غالب الزوز مليانين.	توجد رحلات جوية على شركات جال وانا التي تقلع في الساعة العاشرة وخمسة وخمسين دقيقة . ولكن , للأسف كلتا الرحلتين محجوزتان .
خرج عليا.	تناسبني تماما .
هذا وتاني.	تناسبني تماما .
انجموا ناخذوا طولة بو خمسة؟	هل يمكن أن نحجز طاولة لخمسة أشخاص ؟
نجمو ناخذو طاولة لخمسا عباد؟	هل يمكن أن نحجز طاولة لخمسة أشخاص ؟
ما تفهمش حتى جملة من الانقليزية.	إنها لا تفهم الإنجليزية مطلقا .
ما تفهمش جملة أنقلي.	إنها لا تفهم الإنجليزية مطلقا .
تنجم تتلها بيها من التسعة متاع الصباح لثلاثة هكاكة؟	هل يمكن أن تعتني بها من الساعة التاسعة صباحا حتى الثالثة ؟
تنجم ترد بالك عليها م التسعا متاع الصباح حتى لماضي تلاثا حسب التقريب؟	هل يمكن أن تعتني بها من الساعة التاسعة صباحا حتى الثالثة ؟
قداش يكلف البريد بالطيارة لليابان؟	ما تكلفة البريد الجوي إلى اليابان ؟
سكرت على روحي لبرة. تنجم تحل الباب متاعي، يعيشك.	لقد أُغلق علي الباب . هل يمكن أن تفتح بابي , من فضلك ؟
شنية الخرجة السمحة باش ناراو البلايص المعروفين؟	ما هي أفضل جولة حتى أرى أشهر الأماكن ؟
أناهي الجولة الأحسن باش نشوف لبلايص المعروفين أكثر؟	ما هي أفضل جولة حتى أرى أشهر الأماكن ؟
لا، يا سيد. اليوم نصف النهار معبي الكل. اما غدوة، باهي.	لا يا سيدي . هذه الظهيرة محجوزة بالكامل . ومع ذلك يمكن أن تحجز غدا .
لا، موسيو. بعد نص النهار اليوم الكلو محجوز. أما غدوة، باهي.	لا يا سيدي . هذه الظهيرة محجوزة بالكامل . ومع ذلك يمكن أن تحجز غدا .
نحب نطلب السوم بالضبط للسباق للبواب.	سأذهب كي أسأل البواب عن الأجرة المناسبة .
باش نسأل على السوم بالضبط البواب.	سأذهب كي أسأل البواب عن الأجرة المناسبة .
أنا بالحق نتأسف.	أنا حقا آسف .
عنا حفلة نهار الجمعة في الليل. تنجم تجي بحذانا؟	عندنا حفلة مساء الجمعة . لماذا لا تنضم لنا ؟
عاملين حفلة نهار الجمعة في الليل. تحب تجي بحذانا؟	عندنا حفلة مساء الجمعة . لماذا لا تنضم لنا ؟
هايل، بيتك نومرو تسعمية و ثمنية، يا انسة. اهو مفتاحك.	حسنا , حجرتك يا آنسة هي رقم تسعة صفر ثمانية . هذا مفتاحك .
باهي، بيتك هي تسعا ميا وثمانيا، مادوموازيل. هذا مفتاحك.	حسنا , حجرتك يا آنسة هي رقم تسعة صفر ثمانية . هذا مفتاحك .
سامحني، يا سيدي الشرطي؟	معذرة , ضابط ؟
سامحني، سي. العون؟	معذرة , ضابط ؟
التران هذا يمشي مسترسل لإدنبرة؟	هل هذا القطار يتجه مباشرة إلى إدنبره ؟
خرج حاجاتي الثمينة، يعيشك.	أخرج متعلقاتي الثمينة , من فضلك .
فما برشا عباد في الرحلات؟	كيف يكون الزحام في مثل تلك الجولات ؟
نحب نشري حاجات للذكرى. فماشي مغازة تبيعهم قريبة من هوني؟	أود أن أشتري بعض التذكارات . هل يوجد هنا محل مناسب ؟
خرج توة.	إنه في الخارج الآن .
خرج في الوقت الحالي.	إنه في الخارج الآن .
مايومي، تنجم تكمل الورقة هذه بتصحاحتك؟	مايومي , هل تسمح أن تملأ هذه الورقة بتوقيعك ؟
مايومي، تنجم تكمل الورقة هاذي بتصحيحتك؟	مايومي , هل تسمح أن تملأ هذه الورقة بتوقيعك ؟
هذا ليك، موسيو.	إليك إحداها يا سيدي .
أنا هوني في مهمة إعلامية.	أنا هنا في مهمة إعلامية .
عندك احلام صيفية؟	هل لديكم أفلام للصيف ؟
الترينو الجاي وقتاش لواشنطن دي سي؟	متى يأتي القطار التالي المتجه إلى واشنطن العاصمة ؟
وقتاش التران الجاي لواشنظن دي سي؟	متى يأتي القطار التالي المتجه إلى واشنطن العاصمة ؟
نرجع لليابان الاثنين الجاي.	سأعود إلى اليابان الاثنين المقبل .
باش نرجع لليابان الإثنين الجاية.	سأعود إلى اليابان الاثنين المقبل .
انجمشي ناخذ خريطة للميترو؟	هل يمكنني الحصول على خريطة للمترو ؟
الثنية طويلة؟	هل هو طريق طويل ؟
ياخي المسافة طويلة؟	هل هو طريق طويل ؟
تنجمشي تبدل هذا بواحد جديد؟	هل يمكنك تبديل هذه بواحدة جديدة ؟
تنجم تبدل هذا بواحد جديد؟	هل يمكنك تبديل هذه بواحدة جديدة ؟
زوز من الناس.	شخصان .
زوز عباد.	شخصان .
مانيش مرتاح انجم نتكي كرسية؟	لا أشعر براحة . هل يمكنني حني مقعدي ؟
مانيش حاسس روحي لاباس. نجم نميل كرسيا؟	لا أشعر براحة . هل يمكنني حني مقعدي ؟
الحداش و خمسة و اربعين دقيقة.	الساعة الحادية عشر وخمس وأربعون دقيقة في الصباح .
نص النهار غير ربع.	الساعة الحادية عشر وخمس وأربعون دقيقة في الصباح .
تنجم تقلي على راستورون خاص بالشباب؟	هلا أرشدتني إلى مطعم مفضل بين الشبان ؟
كرهبته تجري على اقوى سرعة.	كانت سيارته تسير بكامل سرعتها .
قداش من مرة لازمني نبدل الترينو باش نمشي لغادي؟	كم عدد المرات التي سأغير فيها القطارات للوصول إلى هناك ؟
قداش من مرة يلزمني نبدل التران باش نمشي لغادي؟	كم عدد المرات التي سأغير فيها القطارات للوصول إلى هناك ؟
بالحق؟ حطني نثبت. اوه، سامحني، سي تاكانو. هذه غلطة منا احنا. اهي الوحدة الصحيحة، بالله صحح هوني، يعيشك؟	هل هذا صواب ؟ دعني أتحقق . أوه ، أسف بشدة آنسة تاكاناو . هذا خطأنا . إليك فاتورتك الجديدة . هلا تفضلت بالتوقيع هنا ، من فضلك ؟
رجعلي خمسة دولار، يعيشك.	الباقي خمسة دولارات ، من فضلك .
رجعلي خمسا دولارات، يعيشك.	الباقي خمسة دولارات ، من فضلك .
السدادة متاع البانو ماتتسكرش باهية.	سدادة حوض الاستحمام لا تقفل بالكامل .
سدادة الدوش ما تتسكرش بالقدا.	سدادة حوض الاستحمام لا تقفل بالكامل .
حاجة متواضعة باش نعبرلك على امتناني.	إنها مجرد هدية تعبيرا عن تقديري .
تنجم تعمر المطبوعة هاذي؟	هلا ملأت هذا النموذج ؟
شنية المودال الي عندك؟	ما هي الماركات التي توجد لديك ؟
شنيا الماركات إلي عندك؟	ما هي الماركات التي توجد لديك ؟
الصباط ياسر عالي.	الكعب عالي جدا بالنسبة لي .
من وقتاش و انتي في باريس؟	كم المدة التي قضيتها في باريس ؟
من وقتاش وإنت في باريس؟	كم المدة التي قضيتها في باريس ؟
انجم ناخذ طوابع بريدية لثلاثة بطاقات بريدية ماشين لليابان بالطيارة؟	هل يمكنني الحصول على طوابع بريدية لثلاث بطاقات بريدية جوية لليابان ؟
نجم ناخو تنابر- بوسطة لتلاثا كوارت بوسطال باش نبعثهم لليابان بالبريد الجوي؟	هل يمكنني الحصول على طوابع بريدية لثلاث بطاقات بريدية جوية لليابان ؟
تتكتب ج-و-ر-و-ه.	تتهجي جي أوه آر أوه اتش .
هذا يتكتب ج-و-ر-و-ه.	تتهجي جي أوه آر أوه اتش .
تحب تشرب حاجة؟	هل تبغي شراباً ؟
تحب أي حاجة تتشرب؟	هل تبغي شراباً ؟
اتمد هوني.	استلقي هنا .
تمد هوني.	استلقي هنا .
ابعث البرقية اكيد، يعيشك.	اجعلها برقية عاجلة ، من فضلك .
أبعث برقية عاجلة، يعيشك.	اجعلها برقية عاجلة ، من فضلك .
نحب كورة.	أبغي كرة .
اكيد، تشرفوا بعملانها.	بكل تأكيد . سنكون سعداء لفعل هذا .
أكيد. باش يكونلنا الشرف إنو نعملوه.	بكل تأكيد . سنكون سعداء لفعل هذا .
اه، صور متحركة من ماليزيا. باش نشري وحدة نهزها معايا للدار. باش تكون حاجة سمحة نحكيو فيها.	هاي ، كتاب كوميدي ماليزي . سأشتري واحداً لآخذه إلى المنزل كقطعة محادثة .
"طريق النجاح هو ""جينمايوكو"" موش مكا؟"	"الطريق إلى النجاح هو "" جينمياكو "" حقاً ؟"
"الطريق للنجاح هو ""جينمياكي""، صحيح؟"	"الطريق إلى النجاح هو "" جينمياكو "" حقاً ؟"
عندي تقريب ألفين وخمسا ميات دولار باليان الياباني.	يوجد لدى حوالي ألفي وخمسمائة دولار بالين الياباني .
ايه، اني باش نوريكم.	نعم ، نحن تفعل . سأريك بعضاً .
إيه. تو نوريهولك.	نعم ، نحن تفعل . سأريك بعضاً .
نحب طوابع نوم.	أبغي بعض الأقراص المنومة .
نحب حرابش منومة.	أبغي بعض الأقراص المنومة .
انا هوني لنهار تسعة. نتمنى تشدوا المجرم فيسع.	سأكون هنا حتى التاسعة . يحدوني الأمل أن تتمكن من القبض على المجرم في أقرب وقت ممكن .
انا متاكد كون المجرم موش بعيد.	إنني على يقين أن المجرم قريب .
أنا متأكد إنو المجرم موش بعيد.	إنني على يقين أن المجرم قريب .
عشرة طوابع، يعيشك.	عشرة طوابع من فضلك .
عشرا تنابر، يعيشك.	عشرة طوابع من فضلك .
عندي وجيعة في قراجمي.	أصبت بالتهاب في الحلق .
عندي وجيعة في قراجمي.	أصبت بالتهاب في الحلق .
نحب حاجة للذكرى من نيويورك.	احتاج إلى بعض الهدايا التذكارية من نيويورك .
أنا محتاج لتذكار من نيويورك.	احتاج إلى بعض الهدايا التذكارية من نيويورك .
باش نمشي. تنجمشي تعيط لحمال؟	إنني أسجل لخروجي من الفندق . هلا أرسلت خادماً إلى أعلى ؟
منقالتي وقفت.	توقفت ساعتي .
منقالتي سكتت.	توقفت ساعتي .
اوه، بالحق؟ كيفاش تحبها؟	أوه ، أهي كذلك ؟ كيف تفضلها ؟
أوه، بالحق؟ كيفاش حبيتو؟	أوه ، أهي كذلك ؟ كيف تفضلها ؟
نحلوا التسعة متاع الصباح.	نحن نفتح في التاسعة صباحاً .
نحب كتاب متاع تلوين.	أريد كتاب تلوين .
نحب كتاب تلوين.	أريد كتاب تلوين .
نتصور عندي الدوخة متاع الهواء.	أظن أنني مصاب بدوار الجو جواً .
نظن عندي دوخة الجو.	أظن أنني مصاب بدوار الجو جواً .
لازمني نمشي لبانكا يابانية؟	هل يجب أن أذهب على بنك ياباني ؟
ياخي يلزمني نمشي لبانكا يابانية؟	هل يجب أن أذهب على بنك ياباني ؟
لازمك تبدل فلوسك في بانكا.	يجب أن تغير النقود من البنك .
يلزمك تبدل فلوسك في بانكا.	يجب أن تغير النقود من البنك .
مازال فمة بارشا وقت قبل الخروج؟	هل لدينا وقت كاف لإنهاء إجراءات المغادرة ؟
ياخي مازال فما برشا وقت قبل المشي؟	هل لدينا وقت كاف لإنهاء إجراءات المغادرة ؟
راجلك من بين الحرفة الباهيين عنا.	زوجك أحد أفضل عملائنا .
راجلك هو واحد من أحسن كليوناتنا.	زوجك أحد أفضل عملائنا .
تعرف طبيب سنان باهي؟	هل تعرف طبيب أسنان جيد ؟
تعرفشي طبيب سنين باهي؟	هل تعرف طبيب أسنان جيد ؟
اوه، لازمك تخبر توة القنصلية.	أوه ، يجب أن تخطر القنصلية على الفور .
أوه. يلزمك تعلم توا القنصلية.	أوه ، يجب أن تخطر القنصلية على الفور .
بالتخضخيض، موش المغرفة.	مهزوز ، وليس مضروب .
بالركاضة، وموش بالمغرفة.	مهزوز ، وليس مضروب .
بارشا عباد يمشيو للشط في الموسم.	يذهب عدد كبير من الناس إلى الشاطئ خلال الموسم .
برشا ناس يمشيو للبحر على طول الموسم.	يذهب عدد كبير من الناس إلى الشاطئ خلال الموسم .
وزنت قرابة مية وخمسين رطل.	وزني حوالي مائة وخمسين رطلاً .
وزنت تقريب ميا وخمسين رطل.	وزني حوالي مائة وخمسين رطلاً .
منين لازمني ناخذ المراسلة؟	إلى أين يجب علي أن أنقل ؟
وين يلزمني ناخو النقل متاعي؟	إلى أين يجب علي أن أنقل ؟
وين يجي مكتب الحاجات الي كانت ضايعة؟	أين مكتب الأشياء المفقودة .
وين موجود بيرو الحاجات الضايعة؟	أين مكتب الأشياء المفقودة .
فما كار تمشي طول؟	هل هناك حافلة تذهب مباشرة إلى هناك ؟
فما كار تمشي مسترسلة؟	هل هناك حافلة تذهب مباشرة إلى هناك ؟
ياخي نحتاج لمعالجة خاصة؟	هل أحتاج لعلاج خاص ؟
بالصرف والا بالكارطة؟	هل سأدفع نقداً أم يضاف على الفاتورة ؟
فلوس ولا بطاقة الخصم؟	هل سأدفع نقداً أم يضاف على الفاتورة ؟
قداش وقت يلزم باش تعملي بطاقة فيزا جديدة؟	كم سيستغرق إصدار التأشيرة لي ؟
وين التواليتات؟	أين غرف الراحة ؟
وين موجودين التوالاتات؟	أين غرف الراحة ؟
السوم النهائي ميتين و ثلاثة و اربعين جنيه، يا للة.	إجمالي المبلغ المطلوب مائتان وثلاثة وأربعون جنيه ، يا سيدتي .
هذي هدية. تنجم تلفهالي في غلاف مزيان؟	هذه هدية ، هل يمكن أن تلفها لي في ورق لف جميل ؟
ملا منضر. رايعة بارشا المنتزهات.	ياله من منظر . إنها مسالك رائعة الجمال .
ملا منظر. هاذم ثنايا مزيانين.	ياله من منظر . إنها مسالك رائعة الجمال .
ايه، عندنا حجز ليلك.	نعم ، لدينا حجز لك .
إيه، عندنا حجز ليك إنت.	نعم ، لدينا حجز لك .
سامحني، نحب نمشي بالكار للوتيل في البلاد. وين ناخذ واحد؟	معذرة أريد الذهاب إلى فندقي في المدينة بالحافلة . أين يمكن أن أستقل حافلة ؟
سامحني، نحب نمشي بالكار للوتيل متاعي في المدينة. منين نجم ناخو واحدة؟	معذرة أريد الذهاب إلى فندقي في المدينة بالحافلة . أين يمكن أن أستقل حافلة ؟
هذه البيت نومرو ميتين و واحد. نحب نطلب فطور الصباح لغدوة.	هذه الغرفة اثنان صفر واحد . أريد أن أطلب إفطار الغد .
هاذي البيت ميتين وواحد. نحب نطلب فطور الصباح لغدوة.	هذه الغرفة اثنان صفر واحد . أريد أن أطلب إفطار الغد .
يالا، حطوا الحشوة من داخل.	إذن دعنا نبطنها من الداخل .
مالا، حطو الحشوة لداخل.	إذن دعنا نبطنها من الداخل .
كيفاش تحبني نحجملك اليوم؟	كيف تحب أن يصفف شعرك اليوم ؟
تنجمشي تعاود بطريقة اخرى؟	هل يمكن أن تقول لي ذلك بعبارة أخرى ؟
تنجم تعاود صياغتو بكلمات أخرين؟	هل يمكن أن تقول لي ذلك بعبارة أخرى ؟
بش نعمل بإلي عندك.	سوف استخدم ما يوجد عندكم .
نحبوا طاولة بجنب الواد.	نريد مائدة بالقرب من المسرح .
نحبو طاولة قريبة م الركح.	نريد مائدة بالقرب من المسرح .
انا لاباس. اي باه، تمشي ساعات؟	أنا بحالة جيدة . حسنا , هل أنت ذاهب إلى مكان ما ؟
احنا على الفين و اربع مية ميترو ارتفاع.	إن ارتفاعه ألفان وأربعمائة متر .
نحن على إرتفاع ألفين وأربعا ميات ميترو.	إن ارتفاعه ألفان وأربعمائة متر .
ادخل. بالله حطه فوق الطاولة غادي.	ادخل . من فضلك ضعها على المائدة هناك .
بالله الغي نومرو الكارطة.	من فضلك الغي رقم بطاقتي .
سامحني، لكلهم تباعوا اما باش يجيونا وحيد اخرين بعد ايام.	آسف لقد نفدت ، لكن سوف تردنا بعد بضعة أيام .
سامحني، تباعو الكل أما باش نجيبو أخرين في ليامات الجاية.	آسف لقد نفدت ، لكن سوف تردنا بعد بضعة أيام .
ما عنديش موعد، اما راهو ضروري.	ليس لدي موعد ، لكن الأمر عاجل .
ما عنديش موعد، أما هذا مزروب.	ليس لدي موعد ، لكن الأمر عاجل .
موش معمول بالباهي.	إنه رديء الصنع .
وين الدروج الي يتحرك؟	أين المصعد ؟
وين لاسنسور؟	أين المصعد ؟
عندكم نشرة على الأحداث؟	هل لديكم كتيب حول العروض ؟
عندك مطوية عل لحداث؟	هل لديكم كتيب حول العروض ؟
وين مدخل الميترو؟	أين مدخل مترو الأنفاق ؟
وين مدخل المترو؟	أين مدخل مترو الأنفاق ؟
ضيعت تسكرة الطيارة.	لقد أضعت تذكرة الطيران الخاصة بي .
ياخي ما تنجمش تبقى هوني في العطل؟	ألا تستطيع البقاء هنا خلال الإجازة ؟
اوه، سامحني كان قلقتك.	أوه ، آسف لأني أزعجتك .
فما تواليت عام قريب من هوني؟	هل توجد غرفة استراحة عامة بالقرب من هنا ؟
فما توالتات عمومية قريبة لهوني؟	هل توجد غرفة استراحة عامة بالقرب من هنا ؟
قداش الكل؟	ما هو الإجمالي ؟
شنيا المجموع؟	ما هو الإجمالي ؟
هايل. توة الأسئلة، يعيشكم.	هذا جيد للغاية . والآن الأسئلة ، من فضلك .
عندك صرف لعداد الباركينق؟	هل لديك أية فكة لعداد الانتظار ؟
عندك صرف لعداد البارك؟	هل لديك أية فكة لعداد الانتظار ؟
لازمني ندور على ليسار؟	هل انعطف يساراً ؟
ياخي يلزمني ندور عل ليسار؟	هل انعطف يساراً ؟
سوم باهي برشا، صحيح؟	سعر رائع ، أليس كذلك ؟
لازمك تاخذه تسعة و تسعين مرة في النهار، قبل الفطور.	لابد أن تأخذها تسعة وتسعون مرة في اليوم ، قبل الوجبات .
يلزمك تاخذو تسعا وتسعين مرة في اليوم، قبل الماكلة.	لابد أن تأخذها تسعة وتسعون مرة في اليوم ، قبل الوجبات .
نحبها بالحق.	أحبه فعلاً .
نحبو بالحق.	أحبه فعلاً .
نحبه بثلاثة ساقين.	أريد حامل ثلاثي .
نحب ركيزة.	أريد حامل ثلاثي .
هايل. نلوج على تكسي، اما باهي.	عظيم . كنت أبحث عن سيارة أجرة لكن هذا أفضل .
عظيم. كنت نلوج على تاكسي، أما هذا خير.	عظيم . كنت أبحث عن سيارة أجرة لكن هذا أفضل .
كبوت سمح بارشا. مخيط في بريطانيا؟	معطف رائع . هل هو صناعة بريطانية ؟
كبوط مزيان. ياخي مخيط في بريطانيا؟	معطف رائع . هل هو صناعة بريطانية ؟
نحب نمشي لسنتر هارفارد. تنجم تقلي وقتلي نوصلولو؟	أريد الذهاب إلى مركز هارفارد . هل يمكن أن تخبرني عندما نصل إلى هناك ؟
زوز كبار و زوز صغار، يعشك.	بالغان وطفلان ، من فضلك .
زوز كهول وزوز صغار، يعيشك.	بالغان وطفلان ، من فضلك .
حرب النجوم عمل اكبر نجاح في عام الف و تسعمية و اربعة و ثمانين.	"كان فيلم "" حرب الكواكب "" أكثر الأعمال شعبية عام ألف وتسعمائة وأربعة وثمانون ."
حرب النجوم عمل أكبر نجاح في سنة ألف وتسعا ميا وأربعا وثمانين.	"كان فيلم "" حرب الكواكب "" أكثر الأعمال شعبية عام ألف وتسعمائة وأربعة وثمانون ."
وين بلاصة الي ما يتكيفوش؟	أين قسم غير المدخنين ؟
وين موجود الفضاء من غير تدخين؟	أين قسم غير المدخنين ؟
"هي ""ت"" كيما توم، ايه اهو هوني، يا تارو."	"حرف "" ت "" "" كما في توم ، نعم ها هي لدي هنا ، تارو ."
شنوة نعملوا بيه؟	ما فائدة هذا ؟
شنوة نوع الكارطة الى تقبلوها؟	أي بطاقات ائتمانية تقبلون ؟
أناهم بطاقات الكريدي إلي تقبلوهم؟	أي بطاقات ائتمانية تقبلون ؟
عندي الوقت الكل.	عندي الكثير من الوقت .
عندي برشا وقت.	عندي الكثير من الوقت .
اي هايل، وقت فطور. تحب نحكيو واحنا نفطروا؟	حسنا ، إنه وقت الغداء . هل تحب أن نناقشه على الغداء ؟
صباح الخير، اسمي اودا. عندي حجز لليلة اما راني با نبطة شوية على التسجيل. بالله حطولي حجزي.	ألو ، اسمي أودا . عندي حجز الليلة ، لكن سوف أتأخر في القدوم . لهذا من فضلك اتركوا لي الحجز .
صباح الخير، إسمي أودا. عندي حجز لليلة أما باش نوصل مخر شوية ع التسجيل. يعيشك خليلي الحجز متاعي.	ألو ، اسمي أودا . عندي حجز الليلة ، لكن سوف أتأخر في القدوم . لهذا من فضلك اتركوا لي الحجز .
الصبابط هذومة ياسر قويين؟	هل هذا الحذاء متين ؟
الصبابط هاذم قويين؟	هل هذا الحذاء متين ؟
قالوا الي القريب ياسر منتشرة غادي.	يقولون إن الأنفلونزا منتشرة هناك .
قالو إنو القريب ياسر منتشر غادي.	يقولون إن الأنفلونزا منتشرة هناك .
بالداخل.	لقد جاء لتوه .
بالداخل.	لقد جاء لتوه .
سامحنا. رانا معبيين غدوة الليل.	آسف . الحجز كامل لمساء الغد .
سامحني. نحنا معبين غدوة في الليل.	آسف . الحجز كامل لمساء الغد .
انا مع صحابي.	أنا مع بعض الأصدقاء .
أنا مع لصحاب.	أنا مع بعض الأصدقاء .
حسب غورو، السيد يامادا عنده زوز صغار.	حسبما يقول جورو ، فاللسيد يامادا طفلان .
حسب غورو، سي يامادا عندو زوز صغار.	حسبما يقول جورو ، فاللسيد يامادا طفلان .
نحب برشا نعمل دورة ببرج لندن.	أريد أن أعرج على برج لندن .
شدوا السبتات.	من فضلكم . اربطوا الأحزمة .
يعيشك أربط أحزمة الأمان متاعك.	من فضلكم . اربطوا الأحزمة .
محجوز.	إنها مشغولة .
هو مشغول.	إنها مشغولة .
عندكم غلال البحر؟	هل لديكم طعام بحري ؟
ياخي عندك فروي د مار؟	هل لديكم طعام بحري ؟
غالي بارشا.	هذا مكلف نوعا ما .
والله نحب، لما سامحني مانجمش نعمله هالمرة.	أود ذلك ، لكنني أخشى ألا أستطيع هذه المرة .
نحب، أما سامحني ما نجمش نعملو الوقت هاذا.	أود ذلك ، لكنني أخشى ألا أستطيع هذه المرة .
اي هايل، مازلت ما نعرفش، اما باش انحاول.	حسنا ، لا أعلم بعد لكنني سوف أحاول بالتأكيد .
إي باهي، مازلت ما نعرفش، أما أكيد باش نحاول.	حسنا ، لا أعلم بعد لكنني سوف أحاول بالتأكيد .
يعيشك إستعمل بيت القياس غادي.	من فضلك استعمل غرفة القياس هناك .
تسعين دولار لتسكرة مشيان. بالصرف والا بالكارطة؟	تسعون دولاراً لتذكرة الذهاب . نقداً أم بالبطاقة ؟
تسعين دولار لتذكرة مشي. صرف ولا بالبطاقة؟	تسعون دولاراً لتذكرة الذهاب . نقداً أم بالبطاقة ؟
كيفاش اليابانيين يربيو صغارهم؟ صعاب معاهم؟	كيف يربي الآباء اليابانيون أولادهم ؟ هل هم صارمون مع أطفالهم ؟
كيفاش اليابانيين يربيو صغارهم؟ هوما صعاب معاهم؟	كيف يربي الآباء اليابانيون أولادهم ؟ هل هم صارمون مع أطفالهم ؟
تنجم تعطيني وقت الحلان؟	هل يمكن أن تخبرني عن ساعات العمل ؟
تنجم تعطيني أوقات الحلان؟	هل يمكن أن تخبرني عن ساعات العمل ؟
ماعدتي رزينة.	معدتي ثقيلة .
عندي معدتي ثقيلة.	معدتي ثقيلة .
انجموا نبداو نلعبوا كيف يوفاو؟	هل يمكن أن نبدأ اللعب عندما ينتهون ؟
ياخي نجمو نبداو نلعبو وقتلي يكملو؟	هل يمكن أن نبدأ اللعب عندما ينتهون ؟
الشعب الياباني قرابت عشرين مليون ساكن.	تعداد سكان اليابان حوالي مائة وعشرينا مليونا .
الشعب الياباني يساوي تقريب ميا وعشرين مليون ساكن.	تعداد سكان اليابان حوالي مائة وعشرينا مليونا .
زيد الحاجات هاذم لبطاقة التسجيل.	املأ البنود الآتية في بطاقة التسجيل .
انجم ناخذ دبشي؟	هل يمكن أن أستعيد متعلقات ؟
ياخي نجم نسترجع حاجاتي؟	هل يمكن أن أستعيد متعلقات ؟
عندكم كاشكولات حرير؟ نلوج على هدية لمرتي.	هل لديكم أوشحة حريرية ؟ إنني أبحث عن هدية لزوجتي .
ياخي عندك خمارات سوا؟ نلوج على هدية لمرتي.	هل لديكم أوشحة حريرية ؟ إنني أبحث عن هدية لزوجتي .
اهو توة باش نجيبوهولك. قداش نومرو بيتك؟	سوف نحضرها الآن . ما هو رقم غرفتك ؟
باش نجيبهولك توا. شنيا نومرو بيتك؟	سوف نحضرها الآن . ما هو رقم غرفتك ؟
نحب نسافر بالبابور من شنغهاي إلى هاواي.	أريد السفر من شنغهاي إلى هاواي بالباخرة .
نحب نسافر بالباطو من شانغهاي حتى لهاواي.	أريد السفر من شنغهاي إلى هاواي بالباخرة .
حاضر الخمسة غدوة؟	هل تستطيع تجهيزه بحلول الخامسة من مساء الغد ؟
تنجم تجهزه الخمسة متاع العشية غدوة؟	هل تستطيع تجهيزه بحلول الخامسة من مساء الغد ؟
ياخذ عشرة دقايق على الساقين.	إنها تستغرق عشر دقائق سيراً على الأقدام .
هذا يشد عشرا دقايق على الساقين.	إنها تستغرق عشر دقائق سيراً على الأقدام .
قبل ما نكمل، تنجموا تعطيوني مشوية وقت؟	قبل أن ننهي العمل ، هلا أعطيتني بضعة دقائق ؟
سكوتش وماء، يعيشك. عندكشي حاجة خفيفة تتاكل؟	ويسكي وماء ، من فضلك . هل لديكم وجبة خفيفة معه ؟
سكوتش مع ماء، يعيشك. ياخي عندك أي حاجة خفيفة تتاكل؟	ويسكي وماء ، من فضلك . هل لديكم وجبة خفيفة معه ؟
كيفاش نطفي الضوء هذا؟	كيف يمكنني أن أطفأ الضوء ؟
كيفاش نجم نطفي الضوء هذا؟	كيف يمكنني أن أطفأ الضوء ؟
مشغول بارشا اليوم؟	هل هو مشغول جدا اليوم ؟
ياخي هو مشغول برشا اليوم؟	هل هو مشغول جدا اليوم ؟
اعطيني شهادة طبية، يعيشك.	اعطني شهادة طبية , من فضلك .
أعطيني شهادة طبية، يعيشك.	اعطني شهادة طبية , من فضلك .
نحبك تزيد تنقص منه إنش من هوني.	أود تقصيره ببوصة واحدة من هذه المنطقة .
ما نيش في فورمة، اعطيني الدواء.	لا أشعر أنني على ما يرام . من فضلك اعطني بعض الدواء .
انجم ناخذ جريدة يابانية؟	هل يمكن أن أختر جريدة يابانية , من فضلك ؟
باهي. انجم نخلي الكرهبة في اي بلاصة؟ وبقداش نخليها؟	حسنا . هل يمكن أن أترك السيارة في أي مكان ؟ ما هي رسوم ركن السيارة ؟
باهي. ياخي نجم نخلي الكرهبة في أي بلاصة؟ وقداش يكلف؟	حسنا . هل يمكن أن أترك السيارة في أي مكان ؟ ما هي رسوم ركن السيارة ؟
شنية الكار الي ماشية لوسط الباد؟	أي حافلة تذهب إلى وسط المدينة ؟
أناهي الكار إلى تمشي لوسط المدينة؟	أي حافلة تذهب إلى وسط المدينة ؟
فما اكسبريس لبوستن؟	هل يوجد أي قطار سريع إلى بوسطن ؟
ياخي فما اكسبريس لبوسطن؟	هل يوجد أي قطار سريع إلى بوسطن ؟
يعيشك. نحب تولي صاحبي ديال المراسلة.	من فضلك كن صديقي بالمراسلة .
يعيشك، نحب تولي مرسالي.	من فضلك كن صديقي بالمراسلة .
انجم نهبط لهيلتون؟	هل يمكن أن أنزل عند فندق هيلتون ؟
ياخي نجم نهبط في هيلتون؟	هل يمكن أن أنزل عند فندق هيلتون ؟
نحب انحهالك.	أريدك تنزعه .
نحبك تبعدو.	أريدك تنزعه .
دور على الليسار في النهج هذا، امشي طول وخوذ اول وحدة على الليمين.	اتجه يساراً في هذا الشارع ثم انعطف عند أول منعطف يمين .
دور عل ليسار في الطريق هذا، ودور مع الدورة لولا عل ليمين.	اتجه يساراً في هذا الشارع ثم انعطف عند أول منعطف يمين .
نحب نعرف انجم نبعث الفاليزات هاذم لطوكيو.	أريد أن أعرف إذا كان يمكن شحن مجموعة الأطباق هذه إلى طوكيو .
نحب نعرف إذا ممكن نبعث كردونة الماعون هاذي لطوكيو.	أريد أن أعرف إذا كان يمكن شحن مجموعة الأطباق هذه إلى طوكيو .
نحب غبرة متاع بدن.	أود بعضاً من القوة الجسدية .
نحب تالك للبدن.	أود بعضاً من القوة الجسدية .
ياخي فما ماكلة موش حارة برشا وموش مفوحة برشا؟	ألا يوجد طعام متبل وليس حارا جدا ؟
ياخي قريب باش نمشي على الساقين؟	هل هو قريب لنصل إليه سيراً .
اتنجم تعديلي الملح، يعيشك؟	هل يمكن أن تمرر لي الملح ؟
ياخي تنجم تعديلي الملح، يعيشك؟	هل يمكن أن تمرر لي الملح ؟
نحب نمشي لوول ستريت. كيفاش نمشي لغادي؟	أريد الذهاب إلى وول ستريت . كيف أصل إلى هناك ؟
برشة تمارين ماتفيدكش.	الكثير جداً من التمارين يضر بك .
برشا تمارين ما يفيدوكش.	الكثير جداً من التمارين يضر بك .
مع فطور الصباح، التاكس و الخدمة داخلة، يكون بخمسة و اربعين دولار الليلة للواحد.	بما في ذلك الإفطار ، والضريبة ، ورسم الخدمة ، سيكون الحساب خمسة أربعون دولارا للشخص الواحد في الليلة .
مع فطور الصباح، التاكس والسرفيس، هذا يكلف خمسا وأربعين دولار الليلة للعبد.	بما في ذلك الإفطار ، والضريبة ، ورسم الخدمة ، سيكون الحساب خمسة أربعون دولارا للشخص الواحد في الليلة .
اتنجم تصلح هذا؟	هل تستطيع تصليح هذا ؟
صباح الخير. شنحوالك.	مساء الخير . أهلا .
ملقيتش باقاجك.	لا أستطيع العثور على أمتعتك .
ما لقيتش دبشك.	لا أستطيع العثور على أمتعتك .
الماء يتشرب؟	هل من المأمون شرب الماء الذي هنا ؟
ياخي الماء صالح للشرب؟	هل من المأمون شرب الماء الذي هنا ؟
اه، يالا. الحكاية الكل زوز دولار.	أهه ، هيا . دولارين فقط .
اه، هيا. بزوز دولارات أكاهو.	أهه ، هيا . دولارين فقط .
تنجم تبدلي الروبة هذه بوحدة اكبر قياس؟	هلا بدلت هذا الفستان بآخر من مقاس أوسع ؟
تنجم تبدل الروبا هاذي بواحدة أكبر قياس؟	هلا بدلت هذا الفستان بآخر من مقاس أوسع ؟
إي باهي، هيا نمشيو. نعاونك في دروسك ومن بعد تو ناكلو بيتزا.	حسنا ، هيا نذهب . أستطيع مساعدتك في واجبك المنزلي بعد أن نتناول بعض البيتزا .
ايه سي تاناكا. فما زوز رسائل ليلك.	نعم ، يا سيد تاناكا هناك رسالتان لك .
ما مشاش معايا.	إنه لا يلائمني .
هذا ما وتانيش.	إنه لا يلائمني .
غدوة نهار جديد.	الغد يوم آخر .
انجم نعاونك. لازمك الفيتامين سي؟	ربما أستطيع مساعدتك . هل تحتاج إلى فيتامين سي ؟
يمكن نجم نعاونك. ياخي يلزمك فيتامين سي؟	ربما أستطيع مساعدتك . هل تحتاج إلى فيتامين سي ؟
نشال سرقلي سطوشي من الترينو.	إن محفظتي نشلت في القطار .
نشال سرق صطوش أوراقي في التران.	إن محفظتي نشلت في القطار .
بعيد بارشا. من المستحسن ناخذوا تكسي.	إنه بعيد جداً . يحسن بك أن تأخذ سيارة أجرة .
هو بعيد برشا. يكون أحسن كان ناخو تاكسي.	إنه بعيد جداً . يحسن بك أن تأخذ سيارة أجرة .
نحب بلاصة بجنب الكولوار، يعشك.	أريد مقعداً يطل على الممر ، من فضلك .
نسكن في علي يتكلفلي ثمانين الف يان في الشهر.	أعيش في شقة إيجارها ثمانون ألف ين في الشهر .
انجم نقص عليك؟	هل لي أن أقاطعكم ؟
نجم نقص عليك؟	هل لي أن أقاطعكم ؟
ايه، مالا.	نعم ، بالطبع .
اهبط للدورة ودور على ليسار مع الضوء.	اذهب إلى الناحية وانعطف يساراً عند إشارة المرور .
نحب نحط حوايجي الغاليين في صندوق الامانات متاع اللوتيل.	أريد إيداع مقتنياتي الثمينة في خزينة الفندق .
ايه، اما ثبت خذيتشي تسكرتك.	نعم ، ولكن تأكد أن تذكرتك معك .
شوية عباد باش يجيو للرحلة الاختيارية.	لن ينضم للجولة الاختيارية إلا القليل من الناس .
كن شوية عباد بش يلتحقوا بالجولة الاختيارية.	لن ينضم للجولة الاختيارية إلا القليل من الناس .
مهما كان. في كل الاحوال، هزني لمركز شيناتون، يعيشك. تو نحاول نلقاها وحدي.	لا تهتم . على أي حال ، خذني من فضلك إلى مركز الحي الصيني . سأحاول أن أجده بنفسي .
أنسى . المهم، يعيشك هزني لسنتر متع صين. توا نحاول نفركس عليه وحدي.	لا تهتم . على أي حال ، خذني من فضلك إلى مركز الحي الصيني . سأحاول أن أجده بنفسي .
عباد جدد باش يدخلوا يخدموا في افريل.	تشغل أشخاصاً جدد في أبريل .
هاكا شنحب.	أرجو ذلك .
نتمنى والله.	أرجو ذلك .
زوز سكوتش و ماء، يعيشك.	اثنان ويسكي مع الماء , من فضلك .
زوز سكوتش وماء، يعيشك.	اثنان ويسكي مع الماء , من فضلك .
شكون يلعب؟	من الذي يعزف ؟
على الليسار، يعيشك.	إلى اليسار ، من فضلك .
عل يسار، يعيشك.	إلى اليسار ، من فضلك .
الضرسة القدامية عاملة فية.	هذه السن في المقدمة تؤلمني .
شنية اخر لعبة الكترونية لوليد عمره خمسطاش سنة؟	ما هي أحدث ألعاب الكمبيوتر لفتى سنه خمسة عشر عاما ؟
شنية اخر فيديو لعب ال طفلة  مراهقة عمرها خمسطاش سنة؟	ما هي أحدث ألعاب الكمبيوتر لفتى سنه خمسة عشر عاما ؟
نشوفوكم غدوة.	سنراك في الغد .
لا، اما يعيشك. نحس بروحي خير.	لا ، ولكن شكراً لك . إنني أشعر بتحسن .
عندك خبز؟	هل لديكم أي خبز ؟
عندك شوية خبز؟	هل لديكم أي خبز ؟
شنوة مستواك على الكامنجة؟	ما هو مستوى مهارتك في عزف الكمان ؟
صاحبي زلق طاح في بيت البانو.	لقد انزلقت قدما صديقي وسقط في الحمام .
صاحبي زلق وطاح في دوش.	لقد انزلقت قدما صديقي وسقط في الحمام .
وين نلقى نفاضة؟	أريد مطفأة سجائر .
نجم ناخو سندرية؟	أريد مطفأة سجائر .
المسيحية تنحات و سكروا البلاد على بقية العالم.	حظرت المسيحية وأغلقت البلاد بالنسبة لبقية العالم .
الكريستينيا منعوها والبلاد تسكرت للعالم لخر.	حظرت المسيحية وأغلقت البلاد بالنسبة لبقية العالم .
قداش تحبوا؟	ما الكمية التي تريدها ؟
قداش تحب؟	ما الكمية التي تريدها ؟
كوكتيل كروفات لها هي وانا زادة كيفكيف.	خلطة جمبري لها ، وكذلك لي .
نجم نطلب منك بش تصحح هوني، إما يعيشك ابدى من هوني.	هلاّ جعلت توقيعك هنا والحروف الأولى من اسمك هنا .
انا فرحان كيف زرتك في مقرك و كيف حكيت بارشا معاك. شكرا على التواصل.	لقد أثلج صدري زيارة مقاركم الرئيسية وكذا ما جرى بيننا من مناقشات مهمة . شكراً جزيلاً على ما أبديتموه من تعاون .
يحسنلي شرف بش نزور شركاتك وناخذو ونعطيو مع بعضنا. يعيشك نشكرك على معاونتك.	لقد أثلج صدري زيارة مقاركم الرئيسية وكذا ما جرى بيننا من مناقشات مهمة . شكراً جزيلاً على ما أبديتموه من تعاون .
تشخر بالقوي.	إن غطيطك مزعج .
شخيرك يقلق.	إن غطيطك مزعج .
بعد كل شيء، اللون ما عجبنيش. انجم نرجعه؟	إن لونها لا يروقني على الإطلاق . هلي يمكنني إرجاعها ؟
نجم نخو شوية فلفل؟	هل لي في بعض الفلفل ؟
معاك سي تاكاهاشي من البيت خمس مية و تسعة و اربعين. تنجموا اطلعولي اربعة كعبات بيرة بيدوايس، يعيشك؟	أنا السيد تكاهاشي بالغرفة رقم خمسة تسعة وأربعين . من فضلك أرسل أربع زجاجات من بيرة بودفايزر .
معاك سي تكاهاشي فيل بيت نومرو خمسة تسعة وأربعين. تنجم تهزل أربعة دبابز بيرة بودوايزو، يعيشك؟	أنا السيد تكاهاشي بالغرفة رقم خمسة تسعة وأربعين . من فضلك أرسل أربع زجاجات من بيرة بودفايزر .
آهم سبعين دولار.	هذه سبعون دولار .
هذم سبعين دولار.	هذه سبعون دولار .
كلمني على اللوتيل متاعي وقت تلقى باقاجي، يعيشك.	من فضلك اتصل بي في الفندق عندما تجد حقائبي .
أمان كلملي لوتيل متاعي وقت تلقالي فليجاتي.	من فضلك اتصل بي في الفندق عندما تجد حقائبي .
نحبكم تكموني و تفيقوني غدوة الصباح الثمنية و نصف، يعيشك.	أريد مكالمة لإيقاظي في الثامنة والصف صباح غد ، من فضلك .
نحب فياقة غدوة في صباح مع ثمانية ونص، يعيشك.	أريد مكالمة لإيقاظي في الثامنة والصف صباح غد ، من فضلك .
ايه، اما بارشا و انا واكل بالباهي.	أجل ، ولكن هذا كثير جدا ، ولقد شبعت بالفعل .
إي، إما هذا برشة وانا مزلت كي غير كليت.	أجل ، ولكن هذا كثير جدا ، ولقد شبعت بالفعل .
نحب ماء معجون اسنان.	أريد غسيلاً للفم .
نحب على شوية غسول فم.	أريد غسيلاً للفم .
منحسش في روحي لاباس.	أشعر بوعكة .
مانيش قد بعضي.	أشعر بوعكة .
طوكيو صفر ثلاثة رباع تسعة أربعة خمسة ستة سبعة.	طوكيو صفر ثلاثة أربعة مرات تسعة أربعة خمسة ستة سبعة .
تنجم تعاوني باش نلقا حديقة الحيوانات؟	فضلا ، ساعدني في العثور على حديقة الحيوان .
تنجم تعاوني بش نلقى حديقة الحيوانات؟	فضلا ، ساعدني في العثور على حديقة الحيوان .
تنجم تقلي كيفاش نريقلوه؟	هلا أخبرتني كيفية تعديلها من فضلك ؟
وقتاش توفا الزيارة بالكار؟	متى بالتقريب ستنتهي جولة الحافلة ؟
وقتاش جولة متاع كار مرة أخرى؟	متى بالتقريب ستنتهي جولة الحافلة ؟
تعرفوا كيفاش يستعمل التاليفون؟	أرني كيفية استعمال الهاتف .
تعرف كيفاش تستعمل تلفون؟	أرني كيفية استعمال الهاتف .
ايه. عندنا ماركات ديال كتب امريكية اصلية سماح.	بالتأكيد . لدينا بعض الماركات الأمريكية الأصلية الجميلة . للكتب .
بالطبيعة. عنا شوية علامات متاع كتب امريكية اصلية محلاهم .	بالتأكيد . لدينا بعض الماركات الأمريكية الأصلية الجميلة . للكتب .
مشغل مكالمات يحكي ياباني، يعيشك.	أريد عامل تشغيل يتحدث اليابانية من فضلك .
بربي مشغل مكالمات يحكي ياباني، يعيشك.	أريد عامل تشغيل يتحدث اليابانية من فضلك .
تنجم تكركرني؟	هل يمكنك أن تجر سيارتي ؟
تنجم دز بية؟	هل يمكنك أن تجر سيارتي ؟
هذه المصحة اف؟	أهذه عيادة إف ؟
هذي مصحة اف؟	أهذه عيادة إف ؟
صباح الخير، انسة ياماغوشي؟ الي باش تكلميه عالخط. مكالمتك بدات. تفضلي، يعيشك.	مرحبا يا سيدة ياماجوتشي ؟ فريقك على الخط . قبلت دعوتك . استمر من فضلك .
عسلامة للا، ياماغوشي. الطرف الآخر عل خط. مكالمتك تقبلت. تفضل، يعيشك.	مرحبا يا سيدة ياماجوتشي ؟ فريقك على الخط . قبلت دعوتك . استمر من فضلك .
وقتاش نوصلوا للوس انجليس؟	متى نصل إلى لوس أنجلوس ؟
وقتاش نوصلوا اللوس أنجلوس؟	متى نصل إلى لوس أنجلوس ؟
كمل في لطويل لمدة خمسة دقايق و دور على ليسار.	سر في نفس الاتجاه حوالي خمس دقائق ثم لف لجهة اليسار .
كمل طول في خمسة دقايق وبعد دور عل يسر.	سر في نفس الاتجاه حوالي خمس دقائق ثم لف لجهة اليسار .
من هوني، للشط.	إنه في هذا الطريق في اتجاه الشاطئ .
هذا طريق لشط.	إنه في هذا الطريق في اتجاه الشاطئ .
ما همش مصنوعين في اليابان، موش هكا؟	لم تصنع هذه باليابان ، أليس كذلك ؟
هاذم مهمش مصنوعين فاليابان، مش هكا؟	لم تصنع هذه باليابان ، أليس كذلك ؟
باهي. من هوني، يعيشك. تو نوصلك لبيتك.	حسناً . خذ هذا الاتجاه . من فضلك ، سأوصلك إلى غرفتك .
لازمني نسيب اللوتيل قبل نصف النهار.	علىّ مغادرة الفندق قبل الظهر .
لزمني نخرج مل هوتيل قبل ضهر.	علىّ مغادرة الفندق قبل الظهر .
زوز هامبرغر و زوز قهاوي، يعيشك. باش نهزوهم.	نريد اثنين هامبورجر واثنين قهوة ، من فضلك ، نريد تناولها خارج المحل .
زوز همبرغر وزوز قهاوي، يعيشك. نحب نهزهم معايا.	نريد اثنين هامبورجر واثنين قهوة ، من فضلك ، نريد تناولها خارج المحل .
انجم نهز معايا الزوز سيكان هاذوما؟	هل يسعني أن استمر في حمل هاتين الحقيبتين ؟
خذيت لحم، موش حوت. تنجم تبدلي؟	لقد طلبت لحما لا سمكا . هل يمكنك تغيير هذا ؟
طلبت لحم، مش حوت. تنجم تبدل؟	لقد طلبت لحما لا سمكا . هل يمكنك تغيير هذا ؟
عندي وجيعة في ماعدتي.	أشعر بالغثيان .
مريض بمعدتي.	أشعر بالغثيان .
الفيستة هذه ماهيش قياسي.	هذا الجاكت ليس مقاسي .
جاكيت هذي مش قياسي.	هذا الجاكت ليس مقاسي .
نحب سي وليام.	أريد لقاء السيد ويليم .
نحب نقابل سي وليام.	أريد لقاء السيد ويليم .
فيه سبعة انواع من الفتامينات و المعادن.	إن بها تشكيلة من سبعة فيتامينات ومعادن .
فيه مجموعة مل فيتامينات والمعادن.	إن بها تشكيلة من سبعة فيتامينات ومعادن .
شنوة فيه الصحن هذا؟	ما هي مكونات هذا الطبق ؟
بش معمول دبش؟	ما هي مكونات هذا الطبق ؟
في اما بلاد تصنع؟	في أي الدول صنعت هذه .
فنا بلد مصنوع؟	في أي الدول صنعت هذه .
تنجم تعملوا في عشرة دقايق؟	أيمكنك الانتهاء من ذلك بعد عشر دقائق ؟
وين انجم نلقى الرموز متاع الميترو؟	من أني يمكنني الحصول على مسكوكة لركوب المترو ؟
عشرين للتجراب اخرين تو يتبعثولك.	سنبعث لك بالبريد عشرين عينة إضافية .
عشرين موديل زيادة توا يوصلوك عل ميل.	سنبعث لك بالبريد عشرين عينة إضافية .
ضاهرلي موش ليلي حيت جلدتي شايحة شوية.	لا أعتقد أن ذلك يناسبني فجلدي جاف إلى حد ما .
منتصورش هاذاك لي خاطر بشرتي شايحة.	لا أعتقد أن ذلك يناسبني فجلدي جاف إلى حد ما .
تنجم تعطيني الاوقات، يعيشك؟	أيمكنني الحصول على جدول زمني ، من فضلك ؟
نجم ناخو جدول أوقات، يعيشك؟	أيمكنني الحصول على جدول زمني ، من فضلك ؟
تسعين دولار الساعة للطفل.	تسعة وتسعون دولاراً في الساعة للطفل ؟
تسعة وتسعين دولار لطفل بليلة.	تسعة وتسعون دولاراً في الساعة للطفل ؟
سامحني اما كل شيء اتاخذ.	آسف لقد نفذ هذا الصنف لدينا .
خسارة، إما كلو تباع.	آسف لقد نفذ هذا الصنف لدينا .
لازمه يكون رايض.	لابد أن تكون هادئة .
لاوم يكون هادي.	لابد أن تكون هادئة .
مفتاح البيت خمس مية و ثلاثة، يعيشك.	أريد مفتاح الغرفة خمسة صفر ثلاثة ، من فضلك .
مفتاح بيت خمسة صفر تلاثة، يعيشك.	أريد مفتاح الغرفة خمسة صفر ثلاثة ، من فضلك .
وين موجود لحجام؟	أين الحلاق ؟
السبعة، يعيشك.	في الساعة السابعة ، من فضلك .
فاليزتي فزدت.	لقد أتلفت حقيبتي .
فليجتي ضاعت.	لقد أتلفت حقيبتي .
سياحة.	لمشاهدة المعالم .
سياحة.	لمشاهدة المعالم .
انا اسبنيولي.	إني من إسبانيا .
جيت من سبانيا.	إني من إسبانيا .
ابعث هذا بالطيارة لليابان، يعيشك.	أرجو أن تبعث هذا بالبريد الجوي إلى اليابان .
أبعثلي هذا بطيارة لليابان، يعيشك.	أرجو أن تبعث هذا بالبريد الجوي إلى اليابان .
ناس محلاهم.	إن الناس ودودون جداً .
وين باب الطلوع للرحلة هذه؟	أين بوابة ركوب الطائرة بالنسبة لهذه الرحلة ؟
فين لباب إلي يطلع لطيارة؟	أين بوابة ركوب الطائرة بالنسبة لهذه الرحلة ؟
نحبوا على الاول نزوروا وول ستريت.	في البداية نود مشاهدة وول ستريت .
أول حاجة، نحبو نشوفو ول ستريت.	في البداية نود مشاهدة وول ستريت .
وين محطة الكار متاع أكسفورد؟	أين محطة الحافلة التي تقصد أكسفورد ؟
فين اخر محطة الكار في أكسفورد؟	أين محطة الحافلة التي تقصد أكسفورد ؟
تو نستنا لين تفرغ بلاصة في التاراس.	سأنتظر حتى يتاح الجلوس في التراس .
انجموا ناراو السطوشات الكوير؟	هل يمكننا أن نلقي نظرة على حافظات جلدية ؟
نجمو نشوفو كراتب م جلد؟	هل يمكننا أن نلقي نظرة على حافظات جلدية ؟
تنجم تقيد عنوانك هوني؟	هل يمكنك كتابة عنوانك في هذا المكان ؟
تنجم تكتب الادريسا متاعك هوني؟	هل يمكنك كتابة عنوانك في هذا المكان ؟
بالله قلي وين اقرب فارماسي.	أخبرني من فضلك أين أقرب صيدلية .
أمان قلي فين أقرب صديدلية.	أخبرني من فضلك أين أقرب صيدلية .
للوتيل متاعي، يعيشك. ادريسة وتيل متاعي هوني.	إلى فندقي ، من فضلك ، إن عنوان فندقي في هذه الورقة .
سكر و استنى شوية، يعيشك.	ابقى على الخط وانتظر لحظة من فضلك .
في داركم، شنوة مستانس تعمل بعد العشاء؟	ماذا تعمل في المعتاد بالمنزل بعد تناول العشاء ؟
فالعادة شنية مستانس تعمل في الدار بعد لعشا؟	ماذا تعمل في المعتاد بالمنزل بعد تناول العشاء ؟
بالحق. وقتاش تحب تلعب قولف؟	بالتأكيد . متى تود أن تلعب جولف ؟
بش تكون في دار مع ماضي تلاثة.	ستكون بالبيت في حوالي الثلاثة .
نحب نكلم سفارة اليابان.	أريد أن اتصل هاتفياً بالسفارة اليابانية .
اكثر بشوية.	زدني قليلاً .
أزيد شوية.	زدني قليلاً .
وين ماشين الكيران للخرجة السياحية؟	من أين تغادر الحافلات لمشاهدة المعالم ؟
منين يخرجوا الكيران السياحية؟	من أين تغادر الحافلات لمشاهدة المعالم ؟
بقداش باش نبعثهم لليابان؟	كم تتقاضى ثمنا لإرسالها لليابان ؟
قداش تخلص بش تبعتهم لليابان؟	كم تتقاضى ثمنا لإرسالها لليابان ؟
اليان الياباني يساعدك؟	هل تقبل بالين الياباني ؟
عندك موستانج؟	هل لديك سيارة من طراز ستانج ؟
نقزنا من العلو هذا؟	هل سنقفز من هنا ؟
بش نطلعو من هوني؟	هل سنقفز من هنا ؟
سي كاواي، عندنا طاولة ليلكم. اجاو من هوني، من فضلك.	يا سيد كاواي لدينا مائدة لك الآن . تفضل من هنا .
سي كاواي، عنا طاولة لك إنت توا. اجى من هوني، يعيشك.	يا سيد كاواي لدينا مائدة لك الآن . تفضل من هنا .
مالا. اهبط الدروج هاذم و توة تشوف البلايك. تبعهم.	بالتأكيد ، انزل من على الدرج هناك وسوف تجد بعض الإرشادات فاتبعها من فضلك .
بطبيعة. امشي تحت دروج غادي وتوا تلقى ثنية. تبعهم.	بالتأكيد ، انزل من على الدرج هناك وسوف تجد بعض الإرشادات فاتبعها من فضلك .
تنجم تحطني في هيلتون، يعيشك؟	هلا أنزلتني عند فندق هلتون من فضلك ؟
طاولة لجماعة ما تتكيفش، يعيشك.	مائة غير المدخنين من فضلك .
لا موش معقول. ديما انت الي تخلص.	ليس هذا صحيحاً . أنت دائما تعاملني .
مش صحيح. ديمة إنت إلي تخلص.	ليس هذا صحيحاً . أنت دائما تعاملني .
أنطق، يعيشك.	تهجى الكلمة من فضلك ؟
الشراب قاعد يسكرني.	بدأت الخمر تثملني .
رد بالك حيت الطقس يتبدل فيسع في الجبل.	احترس لأن الجو في الجبال شديد التقلب .
رد بالك خاطر طقس ياخو ويعطي في جبال.	احترس لأن الجو في الجبال شديد التقلب .
شاك سياحي و ين ياباني، مريقل؟	هل يمكن استخدام شيكات سياحية وعملة ين ياباني ؟
شاك سفر و ين ياباني، باهي؟	هل يمكن استخدام شيكات سياحية وعملة ين ياباني ؟
سامحني، ثبت في مكتب الخدمة ديال البيوت ومكتب المفقودات. ماعندهمش.	آسف ، لقد تحققت من إدارة الخدمة وإدارة المفقودات ولم أجدها عندهم .
سامحني، شفت مع الخدمة ديال البلاصة وبيرو الحاجات الضايعة. ملقاوهوش.	آسف ، لقد تحققت من إدارة الخدمة وإدارة المفقودات ولم أجدها عندهم .
البلاصة صعيب باش تلقاها. في ثنية صغيرة في الخرجة متاع الثنية الوطنية.	يصعب العثور على هذا المكان . إنه في طريق ضيق يتفرع من الطريق الرئيسي .
بلاص صعيب بش تلقاها. طريق صغير فالخرجة متع طريق رئسي.	يصعب العثور على هذا المكان . إنه في طريق ضيق يتفرع من الطريق الرئيسي .
ما نعرف شيء.	لا أعرف شيئاً عن هذا الأمر .
منعرف شي عليه.	لا أعرف شيئاً عن هذا الأمر .
نجم نحكيو فيه في قهوة.	يمكن أن نتحدث حول هذا الموضوع في مقهى .
نشوف، في الحالة هذه، مانيش باش نخلص حق الروتوش، موش هكا؟	فهمت ، في هذه الحالة ليس علىّ أن أدفع أجر التبديلات ، أليس كذلك ؟
نشوف، فالحالة هذي، منجمتش نريقل فلوس ترقيع، لا؟	فهمت ، في هذه الحالة ليس علىّ أن أدفع أجر التبديلات ، أليس كذلك ؟
مشغل المكالمات، يعيشك.	اعطني عامل التليفون من فضلك .
تنجم طيحلي فالكرسي، يعيشك؟	هل يمكن أن تنزل السرج ، من فضلك ؟
باهي. توة ناخذ كان زوز. يعيشك.	حسناً . سوف أخذ اثنين فقط . شكراً .
باهي. بش نخو كن زوز، يعيشك.	حسناً . سوف أخذ اثنين فقط . شكراً .
اهي فاتورتك. تزادت بثلاثمية و سبعة و تسعين دولار.	هاهي فاتورتك . الحساب ثلاثة تسعة وسبعين دولار .
هذي فاتورتك. تلاثة مية وسبعة وتسعين دولار.	هاهي فاتورتك . الحساب ثلاثة تسعة وسبعين دولار .
هاك مزهار.	أنت محظوظ .
ميسلش تشدلنا طاولة مع منظر حلو.	من فضلك اختر لي مائدة ذات منظر ليلي لطيف .
مخدوم باليد والا بالماكينة؟	هل هذا مصنوع آليا أم يدويا ؟
هذا بالماكينة ولا باليد؟	هل هذا مصنوع آليا أم يدويا ؟
نحب نكري النوع هذا من الكرهبة لاربعة وعشرين ساعة.	أود تأجير هذا الطراز من السيارات لمدة أربعة وعشرين ساعة .
نحب نكري كرهبة هذي الأربعة وعشرين ساعة.	أود تأجير هذا الطراز من السيارات لمدة أربعة وعشرين ساعة .
تشرفت بمعرفتك.	كم كان لطيفاً أن التقي بك .
مقطع.	إنه ممزق .
تقطع.	إنه ممزق .
اه باهي، تصور قداش الخدمة هذه تاخذ كان تطرح سؤال ثاني على كل واحد. ايجا، فيسع و خوذ باقاجنا. لازمنا توة نمشيو لمكتب الديوانة.	حسنا ، تصور كيف ستطول فترة عمله لو سأل سؤالاً آخر لكل شخص . هيا بنا ، لنسرع ونحضر حقائبنا . علينا الذهاب إلى الجمارك للإعلان عن أغراضنا بعد ذلك .
باهي، بربي خمم قداش خدمتو كانت ادوم إذا كان سئل كل واحد سوال زيادة. هيا، لزم نزربو نهزو دبشنة. مبعد لزمن نمشو لديوانة.	حسنا ، تصور كيف ستطول فترة عمله لو سأل سؤالاً آخر لكل شخص . هيا بنا ، لنسرع ونحضر حقائبنا . علينا الذهاب إلى الجمارك للإعلان عن أغراضنا بعد ذلك .
قداش الميزان؟	ما هو الوزن ؟
قداش الميزان؟	ما هو الوزن ؟
فما مطعم شنوي موش بعيد من هوني؟	هل يوجد بالقرب من هنا مطعم صيني ؟
فما مطعم صيني في بلاص هاذي؟	هل يوجد بالقرب من هنا مطعم صيني ؟
الموقف خمسة غادي.	إن الرصيف رقم خمسة يقع هناك .
وقتاش ماتش الكورة؟	متى تقام مباراة كرة القدم ؟
وقتاش بش يبدا إساحار؟	متى تقام مباراة كرة القدم ؟
نتصور هذه الفاتورة مافيها حتى غلطة.	أعتقد أن هناك أخطاءً في الفاتورة .
نتصور فما شوية غلاط في الفاتورة.	أعتقد أن هناك أخطاءً في الفاتورة .
بالله اعطيني هذه.	من فضلك اعطني هذه .
يعيشك اعطني الوحدة هاكي.	من فضلك اعطني هذه .
هذا الباب سبعة.	إنها البوابة السابعة .
البوابة اسابعة.	إنها البوابة السابعة .
انت من اسكتلندا؟	هل أنت اسكتلندي ؟
ثلاثة-اثنين-واحد-اثنين. استنى لحضة، باهي؟ نحب نبعثلك حاجة هوني. سامحني.	ثلاثة اثنان واحد اثنان . انتظر ثانية ، حسنا ؟ أريد أن أرسل لك شيئاً هنا . معذرة .
واحد-ثنين-واحد-ثنين. أقعد معايا، اوكي؟ نحب نبعثلك حاجة لهنا. سامحني.	ثلاثة اثنان واحد اثنان . انتظر ثانية ، حسنا ؟ أريد أن أرسل لك شيئاً هنا . معذرة .
الجيب القصير و البوت ما توفاش هوضتهم.	إن الجونلات القصيرة ومعها الأحذية الطويلة لن تنقضي موضتها .
الموضة متع الجوبات القصار وبوتات ماهيش بش توفى جملة.	إن الجونلات القصيرة ومعها الأحذية الطويلة لن تنقضي موضتها .
نجم نكلم المدير؟	هل أستطيع التحدث مع المدير ؟
علاش سومك موش هو بيده الي في العداد؟	لماذا يختلف السعر عن الموجود في العداد ؟
علاش فلوسك مش كيما العداد؟	لماذا يختلف السعر عن الموجود في العداد ؟
انجم نشوف هذه؟	هل يمكن أن أرى هذا ؟
نجم نشوف الوحدة هاذي؟	هل يمكن أن أرى هذا ؟
نوعدك نتعرف عليك اول ما نشوفك.	لعد تعهدت لنفسي بأنني سوف أتعرف عليك عندما أراك .
وعدت روحي وقت إلي نراك، اني بش نتعرف أعليك.	لعد تعهدت لنفسي بأنني سوف أتعرف عليك عندما أراك .
شنوة قاعد يصير في اخر وقت؟	ما الذي كان يحدث منذ الفترة الأخيرة ؟
شنوا صار في الأيامات لخرانين؟	ما الذي كان يحدث منذ الفترة الأخيرة ؟
منحسش في روحي لاباس. تنجم تعطيني اسم طبيب؟	لا أشعر بحالة جيدة . هل ترشدني إلى طبيب ؟
نحس في روحي مش لباس، تكلملي الطبيب؟	لا أشعر بحالة جيدة . هل ترشدني إلى طبيب ؟
الي باش تكلمه عالخط. تفضل.	حفلتك مقامة الآن . تفضل .
الطرف الآخر عالخط. تفضل.	حفلتك مقامة الآن . تفضل .
فما جمهور كبارية؟	هل هناك عرض ترفيهي ليلي ؟
خوذ الدواء هذا بعد الفطور كان وجعك بارشا.	خذ هذا الدواء بعد كل وجبة عندما يزداد الألم .
خوذ دوا هذا بعد كل فطور كن بالحق مريض.	خذ هذا الدواء بعد كل وجبة عندما يزداد الألم .
حط الفلوس في جواب مزين اسمه شوغيبيكورو.	لقد وضعت المال في مظروف خاص مزين يسمى شوجيبوكورو .
حطيت لفلوس في جواب مزين اسمو شجبكرو.	لقد وضعت المال في مظروف خاص مزين يسمى شوجيبوكورو .
فما حد تضرب.	لقد أصيب شخص .
واحد تجرح.	لقد أصيب شخص .
عندك خريطة متع نفق؟	هل لديك خريطة لمترو الأنفاق ؟
عندي ليك بيت حضرة فل وتيل ل كبير. تنجم تمشي غادي؟	لدي غرفة جاهزة لك في جراند هويتل . هل تستطيع الذهاب إلى هناك ؟
عيني ليمين تسطر.	عندي ألم في عيني اليمنى .
عندي وجيعة في عيني لمين.	عندي ألم في عيني اليمنى .
لازمنا نعاوده نتلاقاو اكيد مرة اخرى.	لابد أن نجتمع ثانية بالتأكيد .
تنجم تضيق السروال؟	هلا أخذت هذه السراويل ؟
تنجم تعطيني راكات و كور؟	هل يمكنني استعارة مضرب وكرات ؟
نجم نتسلف مضرب و كور؟	هل يمكنني استعارة مضرب وكرات ؟
تنجم تعطيني شطر دبوزة؟	هل يمكن أن أخذ نصف إبريق ؟
نجم ناخو شطر دبوزة؟	هل يمكن أن أخذ نصف إبريق ؟
سلام. انا جان.	تحية . أنا جون .
أهلا. أنا جان.	تحية . أنا جون .
ناكاي.	ناكاي .
يقلقك كان ناخذلك تصويرة ليك و لتكسيك؟	هل تمانع إذا التقطت صورة لك ولسيارتك الأجرة ؟
تتفكر إلي خذيت معاك تصويرة إنت و تكسيستي متاعك؟	هل تمانع إذا التقطت صورة لك ولسيارتك الأجرة ؟
تكلمت على فليجة ضايعة تلاثة أيام ال تالي.	لقد اتصلت منذ ثلاثة أيام بخصوص حقيبة ضائعة .
للخدمة. عندي علاقات متاع خدمة غادي.	في عمل . لدي صلات عمل هناك .
لل خدمة. عندي معارف خدمة غادي.	في عمل . لدي صلات عمل هناك .
خرج مع كسوتك.	إنه يلائم بزتك .
بالله اعمل طلة على باقاجي؟	هلا راقبت حقيبتي من فضلك ؟
تنجم يعيشك تعسلي عل فليجة؟	هلا راقبت حقيبتي من فضلك ؟
شقولك في الفكرة؟ نقبلوا مطلبك بستة شهور بشرط تضملنا البيعان في ستة شهور من الي يوفا العقد.	كيف تحب هذه الفكرة ؟ نحن نقبل بشرطك الذي ينص على فترة بلاغ مسبق قدرها ستة اشهر شريطة أن تمنحنا الحق بالبيع لمدة ستة أشهر بعد إنهاء العقد .
سامحني، تعرف بالباهي نيويورك؟	معذرة . هل تعرف نيويورك جيدا ؟
سامحني، تعرف نيو يورك مليح؟	معذرة . هل تعرف نيويورك جيدا ؟
نحب نشوف جراح.	أود زيارة جراح .
نحب نشوف جراح.	أود زيارة جراح .
نحب نركب في كرهبة رياضية.	أريد أن أركب في سيارة رياضية .
نحب نطلع في كرهبة متع رياضه.	أريد أن أركب في سيارة رياضية .
رقم الجهة هو صفر ثلاثة. النومرو هو واحد و ثلاثين ثلاثة و عشرين خمسة و اربعين سبعة و ستين.	كود المنطقة هو صفر ثلاثة . والرقم هو ثلاثة واحد اثنان ثلاثة أربعة خمسة ستة سبعة .
رمز ال منطقة هو صفر تلاثة. نومرو هو واحد ثنين تلاثة أربعة خمسة ستة سبعة.	كود المنطقة هو صفر ثلاثة . والرقم هو ثلاثة واحد اثنان ثلاثة أربعة خمسة ستة سبعة .
لقط قريب.	لقد أصيب ببرد .
نحب نبعث توصيل ال عام هذا.	أريد أن أرسل ذلك بطريقة التوصيل العام .
تحبني نحول المكالمة هذه للشخص المسؤول.	دعني أحول هذه المكالمة إلى المسئول .
خليني نعديلك التليفون للشخص المسؤول.	دعني أحول هذه المكالمة إلى المسئول .
شنوة القياس الي تحبه؟	أي مقاس تريد ؟
شنية لي قياس إلي تحبوا؟	أي مقاس تريد ؟
اوه، يا ربي. ما كنتش نتصور باللي مازال عندي هذا.	أوه يا عزيزي . لم أدرك أنني لازلت لدي هذه الأشياء .
اه، عزيزي. معادش نتوقع إلي مازال عندي هاذم.	أوه يا عزيزي . لم أدرك أنني لازلت لدي هذه الأشياء .
عندكم صنادق باش نبعث الكولي هذا؟	هل ليدكم صناديق لإرسال الطرود ؟
مازال عندك بوتا بش تبعث جوبات؟	هل ليدكم صناديق لإرسال الطرود ؟
ياخي شركة الطياران تاخذ على ذمتها مصروف اللوتيل و الماكلة؟	هل ستدفع شركة الطيران رسوم الفندق والوجبات ؟
ياخي جماعة طيارة باش يخلسولي وتيل ومصروف ال مكلة؟	هل ستدفع شركة الطيران رسوم الفندق والوجبات ؟
هذا الكله باقاجك؟	هل هذه كلها هي حقائبك ؟
كيفاش تحب تعدي تاليفونك؟	كيف ترغب في إجراء المكالمة ؟
كيفاش تحب تعملوا تليفون؟	كيف ترغب في إجراء المكالمة ؟
اه باهي، غالي. موش مصنوع في اليابان، موش هكا؟	حسنا ، إنه باهظ الثمن . إنه لم يصنع في اليابان ، أليس كذلك ؟
باهي، غالي رهو. متصنعش فل يابان، هكا؟	حسنا ، إنه باهظ الثمن . إنه لم يصنع في اليابان ، أليس كذلك ؟
وين اقرب مطعم من اللوتيل؟	أين أقرب مطعم لهذا الفندق ؟
فينو أقرب مطعم لل وتيل هذا؟	أين أقرب مطعم لهذا الفندق ؟
نحب شامبوان لشعر عادي.	أريد شامبو للشعر العادي .
نحب شمبو ل شعر العادي.	أريد شامبو للشعر العادي .
شتقول انت باش يلقاوه؟	متى تعتقد سيتم إيجادها ؟
وقتاش تتصور يتلقى؟	متى تعتقد سيتم إيجادها ؟
نتمنالكم عام سعيد.	أتمنى لك عاما سعيدا جدا .
نتمنالك عام مبروك.	أتمنى لك عاما سعيدا جدا .
باش ناخذ الشبح الكبير.	سوف أتناول زجاجة سبرايت كبيرة .
باش ناخو شبح كبير.	سوف أتناول زجاجة سبرايت كبيرة .
نحب بيت تطل على منظر سمح.	أريد غرفة بمنظر جميل .
نحب بيت تل على منظر باهي.	أريد غرفة بمنظر جميل .
ثلاثة كيسان عصير بطيخ، يعيشك.	ثلاثة أقداح من عصير الشمام ، من فضلك .
تلاثة كيسان عصير شمام، يعيشك.	ثلاثة أقداح من عصير الشمام ، من فضلك .
عندي ثلاثة صغار.	عندي ثلاثة أطفال .
عندي تلاثة صغار.	عندي ثلاثة أطفال .
امشي في الهول هاذا و دور في عل يسار في التركينة. توا تشوفو على يمينك.	سر للأمام إلى آخر هذه القاعة وانعطف يسارا عند الركن . سوف تجدها على يمينك .
بقداش تعمل تسكرة مشيان و جيان لأكسفورد؟	كم تبلغ تكلفة تذكرة ذهاب وعودة إلى أوكسفورد ؟
قداش تتكلف تسكرة مشي وجي ال أوكسفورد؟	كم تبلغ تكلفة تذكرة ذهاب وعودة إلى أوكسفورد ؟
نمشي لنادي الرياضة كل نهارين.	اذهب إلى نادي رياضي كل يومين .
وين نقعد في الرحلة؟	أين يمكنني أن أقيم أثناء الجولة ؟
وين نجم نبقى وقت ال رحلة؟	أين يمكنني أن أقيم أثناء الجولة ؟
وقتاش لازمنا نمشيو؟	ما توقيت إجراءات مغادرة الفندق ؟
فنا ساعة لزمك تمشي؟	ما توقيت إجراءات مغادرة الفندق ؟
قداش سوم المرافق لليوم؟	كم يتقاضى المرشد في اليوم ؟
وين نلقا سادايات؟	أين أجد الاسطوانات المدمجة ؟
وين نجم نلقى سديات؟	أين أجد الاسطوانات المدمجة ؟
سامحني، انا تلميذ ياباني. انت طالب في جامعة نيويورك؟	معذرة . أنا طالب جامعي من اليابان . هل أنتم طلاب في جامعة نيويورك ؟
سامحني. إنا تلميذ اعدادية مل يابان. إنت طلب فل جامعة متع نيو يورك؟	معذرة . أنا طالب جامعي من اليابان . هل أنتم طلاب في جامعة نيويورك ؟
تنجم تقللنا كيفاش باش تقيم الخدمة؟	هل من الممكن أن تخبرنا كيف تقيم هذه الخطة ؟
تنجم تقولنا كيفاش تقيم مخطط هذا؟	هل من الممكن أن تخبرنا كيف تقيم هذه الخطة ؟
اكي، تعرف مخزن باهي قريب من هوني؟	أكي ، هل تعرف محل تسجيلات قريب من هنا ؟
أكي، تعرف ستوديو تسجيل قريب من هنا؟	أكي ، هل تعرف محل تسجيلات قريب من هنا ؟
بالصرف ولا بالكارطا؟	نقدا أم ببطاقة الائتمان ؟
نقد ولا شحن؟	نقدا أم ببطاقة الائتمان ؟
نخدم في شركة تجارية.	أعمل في شركة تجارية .
نخدم عند شركة متع تبادل.	أعمل في شركة تجارية .
موش من التربية باش تطلب من الناس قداش تصور.	ليس من الأدب أن تسأل الناس كم يتقاضون .
مش حلو تسال لعباد قداش يخلصو.	ليس من الأدب أن تسأل الناس كم يتقاضون .
هاذوما ليفايز خمسمية و واحد صحاح؟	هل هذه من نوع ليفي خمسة صفر المعتمدة ؟
هذه ليفيز خمسة مية وواحد أصيلة؟	هل هذه من نوع ليفي خمسة صفر المعتمدة ؟
وقتاش انجم ناخذ بانو؟	متى يمكنني أن آخذ حماما ؟
وقتاش نجم نخو دوش؟	متى يمكنني أن آخذ حماما ؟
مطذهرش أكبر من واحد وعشرين.	لا تبدوا أكثر من إحدى وعشرون سنة من العمر .
اني نشوف. بالامارة، فما فيلم سريعة بارشا الداخل. يقلقك كان نجبده؟	أفهم . في الواقع إنه به فيلم عالي السرعة . هل تمانع إذا أخرجته ؟
فهمت. في الحقيقة، فيه فيلم سريع. متتصلصش إذا خرجتو؟	أفهم . في الواقع إنه به فيلم عالي السرعة . هل تمانع إذا أخرجته ؟
توة شريته.	اشتراها الآن فقط .
ثمنية دولار. اهو واحد توة نجيبه.	ثمانية دولارات . وهنا تأتي واحدة حالا .
ثمانية دولار. وهاي جات وحدة توا.	ثمانية دولارات . وهنا تأتي واحدة حالا .
فما تخفيض توا في الحوانيت الشاملة؟	هل أي من المتاجر الكبيرة به يعمل الآن ؟
فما حوانيت شاملة بش يعملوا تخفيضات توا؟	هل أي من المتاجر الكبيرة به يعمل الآن ؟
مشغل المكالمات، عديلي الحماية المدنية.	يا عامل الاتصال ، وصلني بمحطة الإطفاء .
مشغل المكالمات، عديلي مركز الاطفاء.	يا عامل الاتصال ، وصلني بمحطة الإطفاء .
العمارة وفات.	لقد حصلت على بطارية فارغة .
خذيت باتري ميتة.	لقد حصلت على بطارية فارغة .
اقف في التقاطع الي جاي.	توقف عند التقاطع القادم .
اقف فالتقاطع اجاي.	توقف عند التقاطع القادم .
اوه، اهو. ياخي الناس لكل لازمها تعمر المطلب متاع الديوانة؟	آه ، ها هي . هل ينبغي على كل شخص أن يملأ استمارة الإقرار الجمركي هذه ؟
اه، أهوا. ولازم الناس الكل يعمروا الإستمارة متع الديوانة؟	آه ، ها هي . هل ينبغي على كل شخص أن يملأ استمارة الإقرار الجمركي هذه ؟
تنجم تعطيني اسمك، من فضلك؟	ممكن أعرف اسمك من فضلك ؟
ونجم نخو اسمك يعيشك؟	ممكن أعرف اسمك من فضلك ؟
هذا يقلك لو كان نعدي تاليفون علي حساب الي باش نكلمه؟	هل من الممكن إجراء اتصال على أن يتم تحصيل أجرته من الطرف الآخر ؟
يساعدك نعدي مكالمة على حساب الطرف الاخر؟	هل من الممكن إجراء اتصال على أن يتم تحصيل أجرته من الطرف الآخر ؟
صباح الخير، شنحوالك؟	مرحبا . كيف حالك ؟
عسلامة، شنوا حوالك؟	مرحبا . كيف حالك ؟
وين بلاصة الرحلات؟	أين قسم السفر ؟
وين قسم الرحلات؟	أين قسم السفر ؟
شنوة اسم الشخص الي تحب تحكي معاه؟	ما اسم الشخص الذي تود التحدث إليه ؟
شنية إسم شخص إلي تمنيت تحكي معاه؟	ما اسم الشخص الذي تود التحدث إليه ؟
شوف هذاك. شوف هذاك. باش تقلي إختلاف بين الشخص هذاك ولاخر مسألة زهر؟ محمد، اقف يعيشك. ميسالك نوقفك هوني؟ أنا روتار. باهي إلي تقابلنا. مش هكا؟	أنظر إلى هذا . انظر إلى هذا . سوف تخبرني أن الاختلاف بين هذا الشاب وذلك الشاب هو الحظ ؟ محمد ، يقف بالسيارة في جانب الطريق ، وأنت ؟ لن تمانع في أن أنام معك هنا . أنا متأخر . كان لقاء جميل معك ؟
رسايل ليلي انا؟	أية رسائل لي ؟
نحبوا بيت التالي.	نريد غرفة في الخلف .
نحب بيت لتالي.	نريد غرفة في الخلف .
انت ياسر سمحة.	تبدو جميلا .
محلاك.	تبدو جميلا .
ما يقارب تسعة و تسعين ميل.	إنها تبعد حوالي تسعة وتسعون ميلا .
فينس و ليندا يحبوا يبقاو وحدهم، أما سامحني بش نبقى هوني اليلة.	فينس وليندا يريدان أن يبقيا بمفرديهما ، لذا أخشى أنني لا بد أن أبقى هنا هذه الليلة .
بالله تستحفض الباقاج مربوط.	من فضلك احفظ هذه الحقائب في محتجز الجمارك .
خلي الدبش هذا مربوط.	من فضلك احفظ هذه الحقائب في محتجز الجمارك .
اسمي ساتو.	اسمي ساتو .
إسمي هو ساطو.	اسمي ساتو .
نعرف نادي قديم متاع الجاز في البلاد.	أعرف نادي قديم لموسيقى الجاز بوسط البلد .
نعرف نادي دجاز قديم فل مدينة.	أعرف نادي قديم لموسيقى الجاز بوسط البلد .
باش ناخذ هذه المينو الرئيسية.	سأتناول هذه الوجبة .
توا ناخو هذي المينو.	سأتناول هذه الوجبة .
بعد توا ناخذه.	حينئذ سنأخذها .
ياخي يطلع للطابق السادس؟	هل يصعد هذا إلى الدور السادس ؟
هذا يهز ل طابق سادس؟	هل يصعد هذا إلى الدور السادس ؟
بالله حطه في ساشي غسيل وحطه غادي.	من فضلك ضعه في كيس الغسيل و اتركه هناك .
يعيشك حطوا في ساك متع غسيل و خليه غادي.	من فضلك ضعه في كيس الغسيل و اتركه هناك .
نحب نخرج الفيلم هذا. وقتاش يحظر؟	أود تحميض هذا الفيلم . متي سيكون جاهزا ؟
نحب نصلح فيلم هذا. وقتاش يحضر؟	أود تحميض هذا الفيلم . متي سيكون جاهزا ؟
هايل بحذا البرسانة.	النافذة جيدة
خلي القصة هابطة شوية، يعيشك.	اجعل قصة الشعر تتدلى لأسفل , من فضلك .
خليلي لقصة هابطة شوية، يعيشك.	اجعل قصة الشعر تتدلى لأسفل , من فضلك .
مصروف نقل لكل محطوط؟	هل تم إدراج جميع تكاليف النقل ؟
دار عاصمة الأوبرا.	أوبرا ميتروبوليتان .
وين كونتوار اكري-كرهبة؟	أين مكان تأجير السيارات ؟
ماهواش ذوقي.	هذا لا يناسب ذوقي .
مش ذوقي.	هذا لا يناسب ذوقي .
شعندك خضرة؟	ما أنواع الخضراوات الموجودة لديك ؟
شنية الخضرة لعندك؟	ما أنواع الخضراوات الموجودة لديك ؟
وقتاش يجي الطبيب؟	متي سيأتي الطبيب ؟
وقتاش بش يجي طبيب؟	متي سيأتي الطبيب ؟
ما هواش اللون الباهي.	انه اللون الخاطئ .
هذا لون الغالط.	انه اللون الخاطئ .
السنة تكسرت.	لقد انكسرت السنة .
سنة تكسرت.	لقد انكسرت السنة .
بلاصة بحذ الصالة والا بحذ البرسانة؟	هل هذا المقعد بجوار الممر أم بجوار النافذة ؟
وريني واحد لبنية صغيرة.	أرني واحدة لإحدى الشابات .
تنجم تظرب من هوني؟	هل يمكنك أن تتحرك بهذا الاتجاه ؟
تنجم تقف هوني؟	هل يمكنك أن تتحرك بهذا الاتجاه ؟
انا عطشت.	أنا ظمآن .
عطشان.	أنا ظمآن .
بلاش حليب، يعيشك.	بدون حليب , من فضلك .
بلاش حليب، يعيشك.	بدون حليب , من فضلك .
وين الواد؟	أين البحيرة ؟
فين البحيرة؟	أين البحيرة ؟
نجم نشوف مغازة ولا حاجة كيف هكى؟	هل يمكن أن احصل على احدى المجلات أو شيئ من هذا القبيل ؟
لشيرة الجنوب.	انها باتجاه الجنوب .
هذا الجنوب.	انها باتجاه الجنوب .
بقداش هاذم البلايص في البلكون؟	ما تكلفة المقاعد الخاصة بالشرفة ؟
قداش بلايص فالبالكون؟	ما تكلفة المقاعد الخاصة بالشرفة ؟
فما بواتت جواباة قريب من هوني؟	هل هناك أي صناديق بريد قريبة من هنا ؟
باهي. توا نحطو غادي.	و هو كذلك . سأوصلك إلى هناك .
القطعة المكتوبة بالخط المايل تعكس التغييرات الي صارت في سنين الالف و تسعمية و تسعين.	الجزء المكتوب بالطريقة المائلة يشير إلى التغييرات التي حدثت في التسعينات .
الجزء المكتوب ميلا يتكلم على التغييرات إلي صارت في التسعينات.	الجزء المكتوب بالطريقة المائلة يشير إلى التغييرات التي حدثت في التسعينات .
عنده ثاثين سنة.	أنه يبلغ من العمر ثلاثون عاما .
عمرو تلاثين سنى.	أنه يبلغ من العمر ثلاثون عاما .
نحب نمشي لهارودز. تنجم ترسملي خريطة، يعيشك؟	أود الذهاب إلى محل الهارودز . هل معك خريطة , من فضلك ؟
نحب نمشي للهارودز. تصورلي خريطة، يعيشك؟	أود الذهاب إلى محل الهارودز . هل معك خريطة , من فضلك ؟
شتعمل كيف تبدا متفاذي؟	ما ذا تفعل في وقت فراغك ؟
تبيعوا عماير لهذه المصورة؟	هل لديك أحجار بطارية لهذه الكاميرا ؟
عندك بترييات للكاميرا هذي؟	هل لديك أحجار بطارية لهذه الكاميرا ؟
نحب كابل متاع التصوير عن بعد.	أود إرسال برقية لاسلكية .
نحب على كابل متاع التصوير عن بعد.	أود إرسال برقية لاسلكية .
ياخي كنت الأخير في القايمة؟	هل أنت الأخير في هذا الصف ؟
إنت لخراني فل بلاصة هذي؟	هل أنت الأخير في هذا الصف ؟
نتصوره مليان.	أعتقد أن الحجز قد زاد عن العدد .
نتصور إلي تحجز.	أعتقد أن الحجز قد زاد عن العدد .
شوتة باهية. اماضعت.	ركلة موفقة . كادت تدرك الهدف .
رمية بهية. أما لبرا.	ركلة موفقة . كادت تدرك الهدف .
تنجم تقلي شنوة البلايص السماح هوني؟	هل يمكن أن تخبرني عن الأماكن الشيقة هنا ؟
فماشي حوانيت شاملة قريبة مه هوني؟	هل يوجد أي محل متعدد الأقسام قريب من هنا ؟
فما حوانيت شاملة هوني؟	هل يوجد أي محل متعدد الأقسام قريب من هنا ؟
نحب نلتحق بيكم من سان دياجو.	أود اللحاق بالسفر من سان دييجو .
نحب نحظر هذا التكوين الصيف الجاي.	كنت أفكر في الحصول على هذه الدورة في فترة نصف العام المقبلة .
الشراب موش جديد. تنجم تجدده؟	النبيذ ليس باردا بشكل كافي . هل نمكنك أن تجعله أكثر برودة ؟
شنوة الي مهتم بيه اكثر توة؟	ما هي أكثر الأشياء التي تثير اهتمامك الآن ؟
نحب ترجعولي فلوسي . تنجموا تعطيوني فلوسي؟	أريد إعادة المال . هل يمكن أن أحصل على مالي ؟
نحب، نرجع فلوسي، نجم؟	أريد إعادة المال . هل يمكن أن أحصل على مالي ؟
تقريب مشربتش حاجة كما هكى في بلاصة أخرى.	ربما لا يمكنني أن أتناول مثل هذا المشروب في أي مكان آخر .
نشريو هذا زادة، وصلت للمبلغ الي بلاش جمارك.	إذا اشتريت هذا أيضا , فستعمل للمبلغ الذي يعفي من الرسوم .
كان تشري هذا زادة، وصلت لمبلغ بلاش جمارك.	إذا اشتريت هذا أيضا , فستعمل للمبلغ الذي يعفي من الرسوم .
انجم شوف ورقة تلقيحك، من فضلك؟	هل يمكنني أن أطلع على شهادة التطعيم الخاصة بك , من فضلك ؟
تسافر برشا؟	هل تسافر كثيرا ؟
تسافر برشة؟	هل تسافر كثيرا ؟
جيت من اماريكا.	أنا من الولايات المتحدة .
انا جيت من أمريكا.	أنا من الولايات المتحدة .
اذا كان المحطة بعيدة ربع ساعة، تو نمشي على ساقية.	لو إن المسافة خمسة عشرة دقيقة فقط من المحطة ، إذن سأمشيها .
إذا كان بعيدة ربع ساعة كهو على محطة، توا نمشي.	لو إن المسافة خمسة عشرة دقيقة فقط من المحطة ، إذن سأمشيها .
نحب اوتيل رخيص.	أريد فندق أرخص قليلاً .
نحب هوتيل رخيص شوي.	أريد فندق أرخص قليلاً .
راسي يوجعني.	مصاب بالصداع .
عندي وجيعة راس.	مصاب بالصداع .
نحب شهادة طبية و توصيل للسيقورتة.	أريد شهادة طبية وإيصال من أجل التأمين الخاص بي .
نحب سرتفيكا و ورقة ادوه للضمان متاعي.	أريد شهادة طبية وإيصال من أجل التأمين الخاص بي .
منحباش نصرف أكثر من عشرين دولار.	لا أريد إنفاق أكثر من عشرين دولاراً .
علاش مازلنا ما طرناش؟ قلي شنوة فما.	لماذا لم تقلع الرحلة ؟ أخبرني عما يجري .
نحب نكري كرسي متاع شط.	أريد استئجار كرسي مركب .
دقيقة، من فضلك.	انتظر دقيقة من فضلك .
استنى دقيقة، يعيشك.	انتظر دقيقة من فضلك .
ما تشدنيش.	لا تلمسني .
عندك سيقارو؟	هل معك سجائر ؟
عندك سجارو؟	هل معك سجائر ؟
كان ما فماش بارشا ريح، انجموا نمشيو لتيكي بوينت.	يمكننا الذهاب إلى نقطة تيكي إذا لم تكن الريح قوية .
كان ماجاتش اريح قوية، رانا مشينا لتيكي بوينت.	يمكننا الذهاب إلى نقطة تيكي إذا لم تكن الريح قوية .
تحفون.	رائع .
باش نسكر توا، يعطيكم صحة على الإنتباه.	سأغلق الآن . شكراً على انتباهكم .
شكونه؟	من هذا ؟
شكون؟	من هذا ؟
سامحني. تنجمشي تقلي وين انجم نلقى محطة تكسي؟	معذرة . هل لك أن تدلني على مكان موقف سيارات الأجرة ؟
سامحني. تنجم تقولي وين التاكسيات يقفو؟	معذرة . هل لك أن تدلني على مكان موقف سيارات الأجرة ؟
للشربان؟	وللشرب ؟ .
اهوا.	هاهي .
أهوا.	هاهي .
وين موجودة اقرب كانكيوري؟	أين يوجد أقرب متجر لأجهزة الكمبيوتر ؟
امم. ما مشاتش، موش هكا؟ تنجم تبدل البلاصة كان تحب.	هه . إنها لا تعمل ، أليس كذلك ؟ يمكنك الانتقال إلى مقعد شاغر إذا كنت تريد ذلك .
امم. متخدمش، مش هك.	هه . إنها لا تعمل ، أليس كذلك ؟ يمكنك الانتقال إلى مقعد شاغر إذا كنت تريد ذلك .
نلوج على هذا.	إنني أبحث عن هذا .
هايل بارشا، يا سيد. شنوة تاخذ ديسار؟	حسناً سيدي . وما الحلو الذي تريد أن تختم به الطعام ؟
عربة عادية والا بلمان؟	حافلة عادية أم حافلة مجهزة للنوم ؟
عربة ولا جرارة نوم؟	حافلة عادية أم حافلة مجهزة للنوم ؟
شيكات سياحية. يعيشك. اهي تسكرتك و كارتة دخول الطيارة متاعك. بالله ايجا قبل بساعة قبل المشيان.	شيكات سياحية . شكراً . خذ تذكرتك وبطاقة المرور للصعود على متن الطائرة . كن هناك قبل وقت الرحلة بساعة من فضلك .
شيكات متع رحلات. شكراً. أهيا التذكرة و بطاقة الطلوع متاعك. عبد غادي ساعة قبل وقت الطيارة، يعيشك.	شيكات سياحية . شكراً . خذ تذكرتك وبطاقة المرور للصعود على متن الطائرة . كن هناك قبل وقت الرحلة بساعة من فضلك .
اسمي غورو موتوياما. النومرو هو صفر ثلاثة ثنين و ثلاثين ستين و اربعة و عشرين خمسة و تسعين.	الاسم هو جورو موتوياما . والرقم هو صفر ثلاثة ثلاثة اثنان ستة واحد اثنان أربعة تسعة خمسة .
الاسم هو غورو موتوياما. ونومرو هو صفر تلاثة تلاثة ثنين ستة واحد ثنين أربعة تسعة خمسة.	الاسم هو جورو موتوياما . والرقم هو صفر ثلاثة ثلاثة اثنان ستة واحد اثنان أربعة تسعة خمسة .
قلبي يوجعني.	أشعر بمرض شديد .
"شنوا الأوقات إلي باش يعديو فيهم ""كوسيس لف""؟"	"ما موعد عرض "" قصة حب كوسي "" ؟"
اوكي. تاخو قهوتك توا وإلى بعد؟	حسناً . هل ستحتسي القهوة الآن أم فيما بعد ؟
قولي على نادي متع ريقي تحفون في نيو يورك.	دلني على أكثر نوادي موسيقى الريجاي إثارة في نيويورك .
ما فما حتى مشكل كان ما فما حتى حد يسمع نصايح السلامة؟	هل من المقبول عدم اتباع أي شخص لتعليمات الأمن ؟
ياخي نورمال حتى حد مقاعد يسمع فالنصائح متع الامن؟	هل من المقبول عدم اتباع أي شخص لتعليمات الأمن ؟
الزنقة مخطرة؟	هل الشوارع الخلفية خطر ؟
الشارع إلي من تالي يخوف؟	هل الشوارع الخلفية خطر ؟
ايه. اعمل الواجب.	أجل . من فضلك اتخذ الإجراء الضروري .
ايه، واحد برك. وقتاش نكون؟ شنوة قلت في المقابل؟	أجل ، واحدة فقط . متى سأعرف ؟ وكيف سيتم تعويضي ؟
أي، واحد كاهو. وقتاش باش نعلم؟ كيفاش باش تعوضني؟	أجل ، واحدة فقط . متى سأعرف ؟ وكيف سيتم تعويضي ؟
نحبوا طاولة بجنب البرسانة.	نفضل مائدة بجوار النافذة .
نحبو طاولة فين شباك.	نفضل مائدة بجوار النافذة .
أمان قلي على أرخص طريق باش نمشي ل سان فرانسيسكو.	من فضلك دلني على أرخص وسيلة للذهاب إلى سان فرانسيسكو .
تعرفوا مطعم، كيويا؟	هل تعرف المطعم يا كيويا ؟
مشيان كهاو.	اتجاه واحد .
اتجاه واحد.	اتجاه واحد .
تكبر بالقعدة هوني ناكل ديما.	سأصبح بديناً في حال ما ظللت جالساً هنا آكل باستمرار .
بش نسمن مدمني قاعدة ديمة ناكل.	سأصبح بديناً في حال ما ظللت جالساً هنا آكل باستمرار .
فما بواتا باهية فيها عروض فلامينغو؟	هل يوجد ملهى ليلي جيد به عرض رقصة الفلامنكو ؟
فماش بوتا اب عرض فلامنجو؟	هل يوجد ملهى ليلي جيد به عرض رقصة الفلامنكو ؟
روبة تحفونة إلي لبستها.	جميل الفستان التي ترتدينه .
ساقي توجعني.	قدمي تؤلمني .
ما قعدناش جنب لجنب.	تم الفصل بين مقاعدنا .
بلايسنة إتفرقو.	تم الفصل بين مقاعدنا .
بالامارة، نحب نضمن الطرد هذا.	في الواقع أريد استصدار صك تأمين على هذا الطرد أيضاً .
الحق، مذبية إجواب هذا إمسوجر زادة.	في الواقع أريد استصدار صك تأمين على هذا الطرد أيضاً .
العدد وصل للمية دولار.	وصلت الفاتورة لمائة دولار .
ال فاتورة وصلت ميات  دولار.	وصلت الفاتورة لمائة دولار .
هايل برشا، حجزك تاكد.	حسناً ، تم إعادة التأكيد على حجزك .
باهي، الحجز إمتعك عودنا اكدناه.	حسناً ، تم إعادة التأكيد على حجزك .
الصباط عالي بارشا.	الكعب مرتفع جداً .
إطلٌن يسرعالي.	الكعب مرتفع جداً .
انحبو طاولة البرة.	نريد مائدة في الشرفة .
لفيلم ماهوش باهي للصغار الي عمارهم اقل من خمسطاش سنة. الوالدين هوما الي يقرروا صغارهم يتفرجوا و الا لا.	هذا يعني أن الفيلم ربما يكون غير مناسباً للأطفال تحت سن الخامسة عشر . لذلك فإن الآباء بحاجة إلى الأخذ بعين الاعتبار إذا ما كانوا سيدعون الأطفال يشاهدون الفيلم .
يعني الفيلم موش مونسب لصغار الاقل من خمصتشن سنة. يعني لازم الولدين إيشوفو كان إينجموش إيخلو إسغرهم يتفرجو.	هذا يعني أن الفيلم ربما يكون غير مناسباً للأطفال تحت سن الخامسة عشر . لذلك فإن الآباء بحاجة إلى الأخذ بعين الاعتبار إذا ما كانوا سيدعون الأطفال يشاهدون الفيلم .
في اما فورمة تحب الفلوس؟ بالله عمر الورقة و صحح هوني.	كيف تريد النقود ؟ من فضلك املأ هذه الورقة ووقع هنا .
عندي ساعات وجيعة في معدتي.	تؤلمني معدتي أحياناً .
ساعات كرشي توجعني.	تؤلمني معدتي أحياناً .
عندكم ماكلة خفيفة؟ حيتني في ريجيم.	هل لديكم أطباق ذات سعرات حرارية منخفضة ؟ فأنا أتبع نظاما غذائياً حالياً .
عندكمش أصحنة اب أقل كالوري؟ . خطرني إنريجم، توا.	هل لديكم أطباق ذات سعرات حرارية منخفضة ؟ فأنا أتبع نظاما غذائياً حالياً .
إي أندي زوز إتسكر ل جيانتس و دودجرس.	"أجل ، معي تذكرتان ل "" العمالقة "" و "" المحتالين "" ."
يعيشك. حتى انا. ان شاء الله المرة الجاية.	شكراً . وأنا أيضاً . إلى اللقاء فيما بعد .
شكراً . إنا زادة. ودعن حتى لل مرة اجيا.	شكراً . وأنا أيضاً . إلى اللقاء فيما بعد .
بيت لزوز و بانو.	حجرة مزدوجة بحمام من فضلك .
بزوز فروشات ودوش، عيشك.	حجرة مزدوجة بحمام من فضلك .
طحت في الدروج.	لقد سقطت من على درجات السلم .
شنية الثالجة الي تنصحني بيها؟	ما هو الآيس كريم الذي تزكيه ؟
إشنية ال جلاس إلي تنصحني بيه؟	ما هو الآيس كريم الذي تزكيه ؟
زوز وحيد و سبريت.	شريحتين وزجاجة سبرايت .
ايه. يسكن بحذايا في كاليفونيا اما حول لفلوريدا عنده عامين. و انت؟ مسافر وحدك؟	أجل ، أنا . لقد كانوا يعيشون بجواري في كاليفورنيا لكنهم انتقلوا إلى فلوريدا منذ عامين . ماذا عنك ؟ هل تسافر بمفردك ؟
كانوا إيعشيو إقربلي في كاليفورنيا، لكن توا نقلوا عندهم أعمين ال تلي. و إنت؟ إتسافر وحدك؟	أجل ، أنا . لقد كانوا يعيشون بجواري في كاليفورنيا لكنهم انتقلوا إلى فلوريدا منذ عامين . ماذا عنك ؟ هل تسافر بمفردك ؟
انا مريض.	أنا مريض .
انا امريض.	أنا مريض .
ولدي وفاته السخانة.	يبدو طفلي منهكاً بسبب الحمى .
في القياس هذا، يعيشك.	بهذا المقاس من فضلك .
في طي هذا، عيشك.	بهذا المقاس من فضلك .
إترتيب امتع ال اسحاقات إثكفية، فنهار هذا  خاص بالفنانين معينن باحثين .	تمنح أوسمة الاستحقاق الثقافي للفنانين والعلماء المتميزين في هذا اليوم .
انا ياباني.	أنا ياباني .
انا ياباني.	أنا ياباني .
غالي برشا.	هذا ثمنه مرتفع جداً .
ايه. خوذ الكار لكيوتو إيكي.	أجل . استقل الحافلة التي تذهب إلى محطة كيوتو .
محجوز للمشاركين؟	هل هذا للأعضاء فقط ؟
ياخي لل أعضاء كهو؟	هل هذا للأعضاء فقط ؟
انجم ناخذ هذه في الطيارة؟	هل يمكنني أن أحضر هذا على متن الطائرة ؟
انجم انهز هذي معايا  على طيارة؟	هل يمكنني أن أحضر هذا على متن الطائرة ؟
باهي. كل الي نحب نعرفه، اذا كان الخدمة باش توفا بالربح.	حسناً . كل ما أريده هو معرفة إذا ما كان المشروع سيحقق ربحاً .
باهي. إلي انحب نرعفوا إنو ال أفار بش إيسلك روحوا.	حسناً . كل ما أريده هو معرفة إذا ما كان المشروع سيحقق ربحاً .
باهي؛ إتحبش فولار تطلع عليه؟	جميل . هل تريدين إيشارباً يتناسب مع هذا ؟
انا حاضر باش ناخذ.	أنا مستعد للطلب .
انا حاضر بش نطلب.	أنا مستعد للطلب .
اكتب اسم الخطوط الجوية و نومرو الرحلة، زادة.	اكتب اسم شركة الطيران ورقم الرحلة أيضاً .
إكتب هوني إسم شركة الطيران و نومرو الرحلة، زادة.	اكتب اسم شركة الطيران ورقم الرحلة أيضاً .
لحقيقة. اليوم، نهار الاحد، نهار الاحد اخيب نهار.	حقاً . اليوم هو الأحد ، والأحد هو أسوء الأيام .
بالحق. ليوم لحد، و لحد هو أخيب نهار.	حقاً . اليوم هو الأحد ، والأحد هو أسوء الأيام .
ايه، مشكلة في رسكلت الزبلة.	أجل . إنها مشكلة تخلص من الفضلات .
أي، هي مشكلة تتخلص مل بوبال.	أجل . إنها مشكلة تخلص من الفضلات .
نحب النوع هذا بوضع متاع خمسة بلايص.	أريد هذا الطراز لخمسة أماكن مرصعة .
نحب نحط المودال هذا في وضع متاع خمسة بلايص.	أريد هذا الطراز لخمسة أماكن مرصعة .
بارشا عايلات عندها زوز مداخيل.	لدي معظم العائلات مصدرين للدخل .
"اوه. هذه فضة نادرة ""القمرة والجرس"". ثابت تحب تبدلهم؟"	"آه . هذه الفضية نادرة "" القمر والجرس "" . هل تريد أن تغيرها أكيد ؟"
"اوه. لفظة هذي راهي شوية ""القمرة و الناقوز"". مثبت تحب تبدل بها؟"	"آه . هذه الفضية نادرة "" القمر والجرس "" . هل تريد أن تغيرها أكيد ؟"
امي و اختي جايين من اليابان باش يشوفوني. يوصلوا من توة للسبعة.	أمي وأختي قادمتان من اليابان لرؤيتي . سيصلان هنا حوالي السابعة مساءً .
أمي و أختي جاو مل يابان بش يشوفني. باش يصلوا هوني مع سبعة متع لعشية.	أمي وأختي قادمتان من اليابان لرؤيتي . سيصلان هنا حوالي السابعة مساءً .
المارون خارج بارشا السنة.	اللون البني محبب هذا العام .
لمارون خارج لعام هذا.	اللون البني محبب هذا العام .
باهي. زوز بلايص، يعيشك.	حسنا . مقعدان من فضلك .
باهي. زوز بلايص، يعيشك.	حسنا . مقعدان من فضلك .
وين السوق؟	أين السوق ؟
وين سوق؟	أين السوق ؟
ما عاش انجم نزيد نستنى باش نجرب دبش الكورس الجدد.	أود قياس بذلة السباق الخاصة بي .
بقداس تسكرة لادنبرة في الدرجة الأولى، يعيشك؟	ما سعر تذكرة درجة أولى إلى إدنبره , من فضلك ؟
يضهر ناقصين عشرة دولار على لفلوس الي رجعتهملي.	يبدو أن النقود التي أعطيتني إياها ناقصة عشر دولارات .
نكلم في سي سميث على الببيت ميتين و واحد، اما حد ما جاوب. تعرفشي هبطشي الهوني؟	لقد اتصلت بالسيد سميث في غرفة رقم اثنان صفر واحد منذ لحظات ، لكن لم يرد أحد . هل لك أن ترى هل لا يزال يقيم هنا ؟
جيست كلمت سي سميث فل بيت ثنين صفر واحد، أما مفماش جواب. تشوفلي كان مازال هوني؟	لقد اتصلت بالسيد سميث في غرفة رقم اثنان صفر واحد منذ لحظات ، لكن لم يرد أحد . هل لك أن ترى هل لا يزال يقيم هنا ؟
نخدم في دار طباعة.	أعمل في شركة نشر .
نخدم ل شريكة متع إشهار.	أعمل في شركة نشر .
بالله عمر هذا؟	هل لك أن تتفضل وتملأ هذه ؟
تنجم تعمر هذي يعيشك؟	هل لك أن تتفضل وتملأ هذه ؟
كيفاش نقولوا هذا بالانقلاي؟	ماذا تسمون هذا بالإنجليزية ؟
امشي في الثنية هذه. تو تلقاه على ليمين.	ظل سائراً عبر هذا الممر , وستجدها على الجانب الأيمن .
أبقى امشي مع كوان هذاك، بعد توا تلقاه على يمينك.	ظل سائراً عبر هذا الممر , وستجدها على الجانب الأيمن .
نحب نسوقر هذا.	أريد التأمين على هذا .
نحب نضمن في هذا.	أريد التأمين على هذا .
صباح الخير. معاك الاستقبال. شنوة انجم نعملك؟	صباح الخير . هذا مكتب الاستقبال . هل لي أن أساعدك ؟
صباح الخير. معاك الإستقبال. نجم نعاونك؟	صباح الخير . هذا مكتب الاستقبال . هل لي أن أساعدك ؟
هايل بارشا. ادخل مالا.	حسناً . تفضل بالدخول .
باهي. أمان حطوا الداخل.	حسناً . تفضل بالدخول .
عديلي الثنين و ثلاثين تسعة و ستين ثمنطاش.	من فضلك اتصل لي برقم ثلاثة اثنان ستة اثنان تسعة واحد ثمانية .
أمان أطلبلي تلاثة ثنين ستة ثنين تسعة واحد ثمانية.	من فضلك اتصل لي برقم ثلاثة اثنان ستة اثنان تسعة واحد ثمانية .
ايه، انجموا نسربيوك من السبعة.	أجل , يمكننا القيام بخدمتك بداية من السابعة .
تطلق هوني.	من فضلك استلق هنا .
يعيشك إتمد لوطا هوني.	من فضلك استلق هنا .
يمكن تو يضهر.	ربما ستظل ترتفع .
يمكن يعاود يضهر هذا.	ربما ستظل ترتفع .
دور على ليسار في المفترق الجاي.	من فضلك اتجه يساراً عند التقاطع التالي .
ياخي فورد ميسم نجموا نمشيولها بالكار؟	هل توجد خدمة نقل بالحافلات إلى متحف فورد ؟
يجي لليابان في قداش وقت بالطيارة؟	كم المدة التي يستغرقه لكي يصل لليابان عن طريق البريد الجوي ؟
قداش وقت بش توصل لل يابان ب طيارة؟	كم المدة التي يستغرقه لكي يصل لليابان عن طريق البريد الجوي ؟
باهي. نهار الاحد، الساعتين.	حسناً . أراك الساعة الثانية يوم الأحد .
باهي. نشوفك ماضي ساعتين نهار سبت.	حسناً . أراك الساعة الثانية يوم الأحد .
نحب نمشي من نيويورك إلى تورنتو.	أريد أن أمر بنيويورك في طريقي إلى تورونتو .
نحب نمشي على نيو يورك ال تورنتو.	أريد أن أمر بنيويورك في طريقي إلى تورونتو .
القفلة واضح مكسرة. عندكمشي وحيد اخرين من نفس النوعية؟	لقد كسر الزمام المنزلق . هل لديك مزيد من نفس النوع ؟
سلسلة مكسرة. عندك برشة كيما هكا؟	لقد كسر الزمام المنزلق . هل لديك مزيد من نفس النوع ؟
هذا مسخ.	هذا ضرب من الدناءة .
عندك في الاخظر الغامق؟	هل لديك هذا باللون الأخضر الداكن ؟
عندك هذا فل أخضر لغامق؟	هل لديك هذا باللون الأخضر الداكن ؟
منين ناخذ فورشيتة جديدة؟	هل لي بشوكة أخرى ؟
نجم ناخو فرغيتة جديدة؟	هل لي بشوكة أخرى ؟
بارك الله فيك على حسن اخلاقك.	شكراً جزيلاً لعطفك .
يعيشك على معاونتك.	شكراً جزيلاً لعطفك .
سامحني، ما نبيعوش تساكر للمسرح.	آسف ، نحن لا نبيع تذاكر للمسرح .
أسف، منبيعوش تساكر لل مسرح.	آسف ، نحن لا نبيع تذاكر للمسرح .
نحب نشوف هذا.	أريد أن أرى هذا .
اوه، هايل. شنوة لازمني نعمل؟	آه ، هذا جميل . ماذا علي أن أصنع ؟
اه، هاو باهي. شنية لازمني نعمل؟	آه ، هذا جميل . ماذا علي أن أصنع ؟
بدلي بلاستي، من فضلك.	من فضلك غير مقعدي .
أمان بدلي بلاصتي.	من فضلك غير مقعدي .
عندنا كروفات سمحة اليوم.	لدينا جمبري رائع جداً اليوم .
عنا شوية كروفات باهية ليوم.	لدينا جمبري رائع جداً اليوم .
وقتاش يحل مخر؟	إلى أي ساعة متأخرة تظل مفتوحة ؟
تتكيف والا ما تتكيفش؟	للمدخنين أم لا ؟
دخان ولا لا؟	للمدخنين أم لا ؟
غالي بارشا بالنسبة ليلي. تنجم اتيحلي السوم؟	إنه غالي جدا بالنسبة لي . ألا يمكنك تخفيض السعر قليلاً ؟
معملتش حجز.	لم أقم بالحجز .
معملتش حجز.	لم أقم بالحجز .
على خاطر اليابان في الصيف ياسر سخون، و ما عندناش كليماتيزور.	لأن الصيف في اليابان عادة ما يكون شديد الحرارة ، ولم يكن لدينا تكييف هواء قديماً .
تنجم تكلملي تكسي الثمنية غدوة الصباح؟	هل لك أن تستدعي لي سيارة أجرة الساعة الثامنة صباح غد ؟
تنجم تكلملي لواجيست مع ثمانية غدوة صباح؟	هل لك أن تستدعي لي سيارة أجرة الساعة الثامنة صباح غد ؟
هي خايبة.	إنه مريب .
مؤامرة خايبة.	إنه مريب .
علاش ما تستناش الكار تحت البرطال؟	لماذا لا ننتظر الحافلة تحت التندة ؟
علاش منستناش لكار تحت ضل؟	لماذا لا ننتظر الحافلة تحت التندة ؟
ايجا، كينجي. حطني نجي نزورك في المكتب.	تعالى ، كينجي . دعني أريك أرجاء المكتب .
اجا، كنجي. خليني نشوفك بحذ لمكتب.	تعالى ، كينجي . دعني أريك أرجاء المكتب .
كيفاش أزمة مست خدمة؟	كيف أثر الركود على الشركة ؟
عندي موعد أخر.	لدي موعد آخر .
انجم ناخذ بيانو متاع الدار؟	هل لي بخريطة لطرق المدينة ؟
نجم ناخو خريطة طريق متع ل مدينة؟	هل لي بخريطة لطرق المدينة ؟
مفهمتش تفسيرك.	لا أفهم شرحك .
منجمتش نفهم تفسيرك.	لا أفهم شرحك .
تحب تعمل كونيكسيون. امشي لبوسطن.	كان يجب تدبير وسيلة مواصلات . ذاهبة إلى بوسطن .
وين احسن بلاصة للسياحة؟	أين أفضل مكان لمشاهدة المعالم ؟
وين أحسن بلاصة للسياحة؟	أين أفضل مكان لمشاهدة المعالم ؟
وشد روحو؟	هل هي متينة ؟
شخت برشا.	لقد استمتعت كثيرا .
فرهدت روحي برشة.	لقد استمتعت كثيرا .
في الحالة هذه، لازم عندي وجه اصغر من وجه جوليا روبارتس.	حسنا إذاً ، أريد عصا مضرب أصغر كتلك التي مع جوليا روبرتس .
باهي بعد، نحب نولي وجهي صغير كيما جوليا روبرتس.	حسنا إذاً ، أريد عصا مضرب أصغر كتلك التي مع جوليا روبرتس .
تنجم تاخذ هذا، يعيشك؟	هل لك أن تأخذ هذا ، من فضلك ؟
تنجم تاخو هذا، يعيشك؟	هل لك أن تأخذ هذا ، من فضلك ؟
مسافرين الخطوط الجوية ايه بي سي رحلة سبع مية و ثلاثة الي ماشية لطوكيو بالله يمشيو للباب نومرو عشرين للاجراءات الحكومية.	الركاب المسافرون على خطوط إيه بي سي الجوية رحلة رقم سبعة صفر ثلاثة المتجهة إلى طوكيو التفضل بالتوجه إلى بوابة رقم عشرين لإنهاء الإجراءات الرسمية .
المسافرين الراحلين على الخطوط الجوية اي بي سي رحلة سبعة صفر ثلاثة دركسيون طوكيو مذابين يقدموا لباب عشرين للإجراءات الرسمية.	الركاب المسافرون على خطوط إيه بي سي الجوية رحلة رقم سبعة صفر ثلاثة المتجهة إلى طوكيو التفضل بالتوجه إلى بوابة رقم عشرين لإنهاء الإجراءات الرسمية .
وين موقف الكار متاع بي؟	أين موقف الحافلات ل بي ؟
وين تاقف الكار متاع بي؟	أين موقف الحافلات ل بي ؟
عادين، يعيشك.	الدخول فرداً فردا ، ً من فضلكم .
نجم نركروتي قيد يحكي ياباني؟	هل يمكنني استئجار مرشداً يتحدث اللغة اليابانية ؟
تحب نصورك؟	هل تريدني أن ألتقط لك صورة ؟
ما خذيتش الصحن هذا.	لم يكن لدي هذا الطبق .
معنديش الماكلة هادي.	لم يكن لدي هذا الطبق .
جرحت صبعي. عندكمشي دواء متاع قيح؟	لقد قطع إصبعي . هل يوجد مطهر ؟
قصيت صبعي، فما معقم؟	لقد قطع إصبعي . هل يوجد مطهر ؟
نكون هوني الثمنية غير ربع.	سأكون هنا الساعة الثامنة إلى الربع .
نحب اوفاح.	أريد عطراً .
نحب شويا برفوم.	أريد عطراً .
منين نشوف الوقت؟	هل لي بجدول مواعيد ؟
نجم ناخو جدول الاوقات؟	هل لي بجدول مواعيد ؟
هيلتون بعيد من هوني؟	هل فندق هيلتون بعيد عن هنا ؟
هوتيل هيلتون بعيد من هنا؟	هل فندق هيلتون بعيد عن هنا ؟
متأكد الي حطيته في كلاسوري.	أنا متأكد أنني وضعتها في محفظة الأوراق الخاصة بي .
متاكد إلي حطيته في ساكي.	أنا متأكد أنني وضعتها في محفظة الأوراق الخاصة بي .
يديكم الفوق.	ارفعوا أيديكم .
يديك الفوق.	ارفعوا أيديكم .
فما مطعم تنصحنا بيه قريب من هوني؟	هل يوجد مطعماً يمكنك أن تزكيه بالقرب من هنا ؟
فماش مطعم قريب تنجم تطلب منو؟	هل يوجد مطعماً يمكنك أن تزكيه بالقرب من هنا ؟
شنوة تحب، الغامق ولا الفاتح؟	أيهما تفضل , داكن أم فاتح ؟
شنوة تفظل، إظلام ولا إضو؟	أيهما تفضل , داكن أم فاتح ؟
تنجم تقلي وين ماشين؟	هل لك أن تخبرني عن مكان تحليق الطائرة الآن ؟
تسكرة بعثان، يعيشك.	تذكرة نزول وركوب طائرة أخرى من فضلك .
تذكرة متع نقل، من فظلك.	تذكرة نزول وركوب طائرة أخرى من فضلك .
وين انجموا نلقاو بلاصة باهية باش نعملوا خرجة بنهار؟	أين يوجد مكان لطيف لقضاء نزهة ليوم واحد ؟
وين نلقى بلاصة تحفونة لنهار متع دورة؟	أين يوجد مكان لطيف لقضاء نزهة ليوم واحد ؟
نحب الساك كللي الاحمر الي في نفس الفورمة مع هذا.	أريد حقيبة كيلي حمراء نفس هذا الطراز .
مازلنا نجموا نحطوا التواريخ؟	هل ستزال تعمل جدول المواعيد ؟
مزلت بش تمشي على إجدول هاك؟	هل ستزال تعمل جدول المواعيد ؟
وقتاش تحل البانكا؟	متى يفتح المصرف ؟
في أما وقت تحل البانكة؟	متى يفتح المصرف ؟
نحس فروحي موش لاباس.	أشعر بالإعياء .
نحس في روحي مريض.	أشعر بالإعياء .
داخل بعضو. تسورلي بيانو؟	سأرتبك . هل تمانع في رسم خريطة لي ؟
أنا دخلت بعذي، تنجم تصورلي خريطة؟	سأرتبك . هل تمانع في رسم خريطة لي ؟
لازم نجي لسبيتار كل يوم؟	هل يجب أن آتي إلى المستشفى كل يوم ؟
عندي وجيعة في ماعدتي.	معدتي تؤلمني .
كرشي توجع فيا.	معدتي تؤلمني .
بقداش طوابع البريد باش نبعث الجواب هذا لليابان؟	كم أجرة البريد لإرسال هذا الخطاب إلى اليابان ؟
بقداش تيمبري باش نبعث ها جواب ليابان؟  ؟	كم أجرة البريد لإرسال هذا الخطاب إلى اليابان ؟
نحب كاس خمر.	أريد زجاجة من نبيذ شيري الأسباني .
مذابيا على كاس شري.	أريد زجاجة من نبيذ شيري الأسباني .
لازم تجي تلوج على المطار؟	هل تريد أن يأتي أحد ليأخذك من المطار ؟
تحب شكون يجيبك ملمطار؟	هل تريد أن يأتي أحد ليأخذك من المطار ؟
من ثلاثين الف يان.	من ثلاثين ألف ين .
منين نجم نشري كارطة تالفون؟	من أين يمكنني شراء بطاقة هاتف ؟
انجم نرجعه في بلاد اخرى؟	هل يمكنني إعادتها في مدينة مختلفة ؟
نجم نرجعه في بلاصة أخرى؟	هل يمكنني إعادتها في مدينة مختلفة ؟
اجبد شوية من الفوق.	من فضلك اجعل الجزء العلوي أطول قليلاً .
أمان خلي لفوقاني طويل شوية.	من فضلك اجعل الجزء العلوي أطول قليلاً .
لازمك تشوف مختص.	تحتاج لرؤية أخصائي .
تحب تشوف طبيب مختص.	تحتاج لرؤية أخصائي .
تبع رقمأربعطاش.	مسار رقم أربعة عشر .
اوه، بالحق. عندك برشا خيارات.	آه ، عندك ؟ بالتأكيد إن لديك تشكيلة كبيرة .
اه، عملتو؟ بالحق عندك شعبية كبيرة.	آه ، عندك ؟ بالتأكيد إن لديك تشكيلة كبيرة .
نحب نسخة من ورقة السرقة.	أريد نسخة من تقرير السرقة .
نحب نسخة م رابور المسروق.	أريد نسخة من تقرير السرقة .
تنجم تعديلي ضو كيف تدخل غادي؟	هل لك أن تعطيني إشارة بالضوء عندما تكون فيها ؟
هايل. كيف هكا.	حسنا . مثل هذه فسحب .
باهي ياسر. كما هكاكة.	حسنا . مثل هذه فسحب .
الاكسبريس الجاي بعد ساعة.	سيأتي القطار السريع التالي بعد ساعة .
الايكسبريس الجاي بعد ساعة.	سيأتي القطار السريع التالي بعد ساعة .
نحب نطول في يدين البلوزان متاع الرياضة.	أود أن أجعل أكمام هذا الجاكت الرياضي طويلة .
نحب نطول في لبست سبور.	أود أن أجعل أكمام هذا الجاكت الرياضي طويلة .
عيد ميلادك في طريق.	عيد ميلادك اقترب .
تنجم تصلح هذا؟	هل يمكنك أن تصلح ذلك ؟
ثاني عمارة على اليسار متاع البنية البيضة.	إنه المبنى الثاني على يسار هذا المبني الأبيض .
ال بنية ثانية عل يسار ال بنية ثالثة.	إنه المبنى الثاني على يسار هذا المبني الأبيض .
ريزارفينا بلاصة نهار خمسة و عشرين أكتوبر لحداش متاع النهار.	حجزنا مقعداً ليوم الخامس والعشرين من أكتوبر في الساعة الحادية عشر صباحاً .
حجزنا بقعة ال أكتوبر خمسة و عشرين خارجين مع لحداش صباح.	حجزنا مقعداً ليوم الخامس والعشرين من أكتوبر في الساعة الحادية عشر صباحاً .
ايه، الماكلة ماهياش داخلة.	لا . قليلاً في الأمام . هناك ، نعم .
لا، لقدام شوية، غادي، إي.	لا . قليلاً في الأمام . هناك ، نعم .
أي، هذا مفيهش ماكلة.	نعم ، هذا لا يشمل الوجبات .
منين نجم نرجع سوم التسرة؟	أين يمكنني استعادة ثمن هذه التذكرة ؟
وين نجم نرجع فلوس تسكرة هذي؟	أين يمكنني استعادة ثمن هذه التذكرة ؟
علاش هذا يصير ساعات؟	لماذا يحدث هذا ؟
علاش صار؟	لماذا يحدث هذا ؟
نحب نشوف الباقي.	أريد أن أحصل على استراحة .
كرهبتي عوقت. ايجا هزها يعيشك.	لقد تعطلت سيارتي . من فضلك احضر لتأخذها .
كرهبتي عدمت، يعيشك اجا هزهالي.	لقد تعطلت سيارتي . من فضلك احضر لتأخذها .
نحب شعري طويل شوية من تالي.	أريد أن يكون شعري خلف رأسي أطول قليلاً .
نحب شعري طويل شوية في ضهر.	أريد أن يكون شعري خلف رأسي أطول قليلاً .
شنوة الأنواع الي عندك؟	ما هي الأنواع التي لديكم ؟
شنية لانواع ل عندك؟	ما هي الأنواع التي لديكم ؟
شنوة التصور اللي عندك في مخك؟	ما هو نوع النموذج الذي تفكر فيه ؟
شنية ال موديل في مخك؟	ما هو نوع النموذج الذي تفكر فيه ؟
تنجم تعطيني خريطة مبسطة للبلاصة الي احنا فيها؟	من فضلك ، هل رسمت لي خريطة بسيطة من هنا ؟
وين نتقابلوا؟	أين نتقابل ؟
وقتاش نتقابلو؟	أين نتقابل ؟
نحب نفس الحجامة كيف قبل.	أود تصفيف شعري بالطريقة التي كان عليها من قبل .
اعطني خمسين، يعيشك.	أعطني خمسين ، من فضلك .
منين سجل للخطوط الجوية اليابانية؟	أين يمكنني أن أقوم بإجراءات الدخول للخطوط الجوية اليابانية ؟
وين نقيد للخطوط الجوية اليابانية؟	أين يمكنني أن أقوم بإجراءات الدخول للخطوط الجوية اليابانية ؟
شفيه؟	ما هي المحتويات ؟
فماشي بلايص سماح في الحي؟	هل هناك أي أماكن في المنطقة تلقي تزكية كثيرة ؟
فما بلايص هوني منصوح بها؟	هل هناك أي أماكن في المنطقة تلقي تزكية كثيرة ؟
اعطيني الفلوس، يعيشك.	من فضلك أعطني بعض الفكة .
هايل برشا. تو نعس لين الساك يكون هوني.	حسناً . سأتأكد أن حقائبك ستكون هنا .
باهي. باش نأكدلك إلي فليجتك كل باش تكون هوني.	حسناً . سأتأكد أن حقائبك ستكون هنا .
هذي اختصاصنا، نداس مشوي.	هذا هو طبقنا المميز , سمك موسى المشوي الخاص بدوفر .
هذا اختصاصنا، دوفر ال مشوي ال وحيد.	هذا هو طبقنا المميز , سمك موسى المشوي الخاص بدوفر .
باش نقعدوا.	سنمكث .
باش نبقاو.	سنمكث .
ضربوني.	لقد تعرضت لعملية سلب .
تسرقت.	لقد تعرضت لعملية سلب .
هايل برشا، لازمني نركز؟	حسناً . هل يجب أن أقوم بتركيزها ؟
باهي. لازمني نعينو؟	حسناً . هل يجب أن أقوم بتركيزها ؟
ما عندناش المودال هذا. تو نثبت في المخزن. استناني دقيقة، يعشك.	لا يوجد لدينا نفس الطراز الآن . سأفحص مخزوننا . انتظر دقيقة من فضلك .
معناش ستيل هذا تو نتفقدلك إشعنة سلعة. استنى ادقيقة عيشك.	لا يوجد لدينا نفس الطراز الآن . سأفحص مخزوننا . انتظر دقيقة من فضلك .
سكوتش بالماء، يعيشك.	ويسكي اسكتلندي وماء من فضلك .
يضهر باهي. قداش يعمل؟	هذا يبدو رائعاً . ما الثمن ؟
هز آوردنونس للفارماسي. تو تلقى الدواء.	خذ هذه التذكرة الطبية إلى الصيدلية . يمكنك الحصول على الدواء من هناك .
هز ال اوردنانس هذي للفرمسي. تنجم تاخد دوى من غادي.	خذ هذه التذكرة الطبية إلى الصيدلية . يمكنك الحصول على الدواء من هناك .
خذيت هذا.	لقد طلبت ذلك .
إنا إطلبت هذا.	لقد طلبت ذلك .
ايه تنجم تاقف في المحطة الي حاجتك بها من هوني لشيكاغو.	نعم , يمكنك أن تتوقف في أي محطة ما بين هنا وشيكاغو .
منين نشري حاجات للذكرى؟	من أين يمكنني شراء بعض الهدايا التذكارية ؟
غالي برشا. منجمش نشريه.	إنها غالية الثمن . لا أستطيع شرائها .
غالية برشة . منجمش نشريها.	إنها غالية الثمن . لا أستطيع شرائها .
نجم ناخذ نومرو إيه بي سي آند كومباني في شيكاغو، يعيشك.	هل يمكنني أن أحصل على رقم تليفون إيه بي سي والشركة في شيكاغو من فضلك ؟
إتنجم تعطيني نومرو إيه بي سي آند كومباني في شيكاغو، عيشك.	هل يمكنني أن أحصل على رقم تليفون إيه بي سي والشركة في شيكاغو من فضلك ؟
كيفاش تحب عضماتك؟	كيف تحب أن تأكل البيض ؟
كيفاش اتحب لعذذم إمتيعك؟	كيف تحب أن تأكل البيض ؟
ايه بجنب البنية هذه.	يوجد بجانب هذا المبني تحديداً .
بعد البنية هذي بضبط .	يوجد بجانب هذا المبني تحديداً .
لا، ضاهرلي نساو باش يجيبولنا واحد.	لا , أعتقد أنهم نسوا أن يحضروا واحدة لنا .
انسو بش إيجبولنة وحدة.	لا , أعتقد أنهم نسوا أن يحضروا واحدة لنا .
باهي. اتاكد. انجموا ناخذوا نومروك متاع التالفون، في صورة ما استحقينا نكلموك؟	حسناً . لقد تم التأكيد . هل يمكننا أن نأخذ رقم تليفونك في حالة الحاجة إلى الاتصال بك ؟
باهي. توا إتكدنة. نجم ناخد رقم تليفونك، ربما نعاود نكلموك؟	حسناً . لقد تم التأكيد . هل يمكننا أن نأخذ رقم تليفونك في حالة الحاجة إلى الاتصال بك ؟
شسمو الرسام؟	ما هو اسم الرسام ؟
إشنية إسم ارسام؟  ؟	ما هو اسم الرسام ؟
لازمني نطلب منه باش يكلمك كيف يجي؟	هل أجعله يعاود الاتصال بك عندما يعود ؟
إنقلو يطلبك بعد كي ايجي؟	هل أجعله يعاود الاتصال بك عندما يعود ؟
نحب هذه.	أود أن آخذ هذا .
مذابيا نخو أذكة.	أود أن آخذ هذا .
حبيت الشراب هذا متاع الاستقبال بعد الركوب. نشربوه على صحتك.	أحب هذه الخدمة بتقديم شامبانيا للتحية بعد الإقلاع . دعني أشرب فى صحتك .
اربعين دولار النهار مع عشرة سنت للميل.	أربعون دولار يومياً ، بالإضافة إلى ثمانية سنت لكل ميل .
بش نتخاتر على خمسة دولار.	أراهن بخمسة دولارات .
ماهياش سلعة واحد آخر؟	هل هذا طلب شخص آخر .
موش هذي طلبيت شخص أخر.  ؟	هل هذا طلب شخص آخر .
تنجم تقلي كيفاش نمشي للمتحف؟	هل قلت لي كيف أذهب إلى المتحف ؟
سامحني، اما نحب نأجل الموعد.	آسف جدا ، لكني أود تأجيل الميعاد .
أنا متاسف، أما نحب ناجل إل موعد.	آسف جدا ، لكني أود تأجيل الميعاد .
الترينو متاعك يخرج من البلاصة نومرو ثمنية.	سيغادر قطارك من الرصيف رقم ثمانية .
تران متعك بيش يخرج مل رصيف ثمنية.	سيغادر قطارك من الرصيف رقم ثمانية .
نحبها باقل من مية و ثمانين دولار.	أود أن تبقي تحت مائة وثمانين دولار .
نحب يبقى سومه تحت ميا و ثمانين دولار.	أود أن تبقي تحت مائة وثمانين دولار .
نطلب منك مرة الي عندي الوقت باش نعمل طلة.	سأسلك بعد أن ألقي نظرة هنا وهناك .
توا نسلك بعد منشوف.	سأسلك بعد أن ألقي نظرة هنا وهناك .
تنجم توريني وحيد اخرين بمنضر اخر؟	هل يمكنك أن ترني أشياء أخري ذات تصميمات مختلفة .
إتنجم إتورني وحداة اخرين اب تصميم اخر؟	هل يمكنك أن ترني أشياء أخري ذات تصميمات مختلفة .
شنوا نوع عصير إلي تحبو؟	ما نوع العصير الذي تفضله ؟
باش ترجع لدارك في العطلة؟	هل ستعود لبلادك في الاجازات ؟
بش تراوح لداركم فل عطلة؟	هل ستعود لبلادك في الاجازات ؟
عيد الشكر. نهار لشكر كل الي يحميوا المجتمع بالخدمة.	عيد الشكر والعمال ، فهو يوم الشكر لكل الذين ساندوا المجتمع بأعمالهم .
عيد شكر عمل إلي يقوموا فيه بشكر لعمال.	عيد الشكر والعمال ، فهو يوم الشكر لكل الذين ساندوا المجتمع بأعمالهم .
البيت هذه ياسر صغيرة.	هذه الغرفة صغيرة جداً .
لبيت هذي صغيرة.	هذه الغرفة صغيرة جداً .
زيدني شوية تي عيشك؟	هل يمكنني أن أحصل علي مزيد من الشاي ، من فضلك ؟
نحب نغسل الدبش في اقصى وقت الصباح.	أريد أن أغسل ملابسي في وقت لاحق اليوم .
نحب لبستي تتنظف ليوم بعيد شوية.	أريد أن أغسل ملابسي في وقت لاحق اليوم .
فما بانكا من هوني؟	هل يوجد بنك بالقرب من هنا ؟
فما بنكا هوني؟	هل يوجد بنك بالقرب من هنا ؟
تسيبولنى الطولة، يعيشكم؟	هل من الممكن أن تنظف المنضدة من فضلك ؟
تنجم تفضلي طاولة عيشك؟	هل من الممكن أن تنظف المنضدة من فضلك ؟
موسى، يعيشك.	سكين ، من فضلك .
سكينة، يعيشك.	سكين ، من فضلك .
قيد نومرو بيتك في الضهر.	من فضلك ، اكتب رقم الغرفة في الخلف .
يعيشك إكتب نومرو بيتك من تالي.	من فضلك ، اكتب رقم الغرفة في الخلف .
لازمنا خبزة باش ناكلوا.	نستخدم الأعواد عندما نأكل .
نستعملو أعواد متع ماكلة كي ناكلو.	نستخدم الأعواد عندما نأكل .
الرحلة دلتا نومرو ثمنية و عشرين الي ماشية لنيو اورليانز باش توخر ساعة.	رحلة الطيران دلتا رقم ثمانية وعشرون والمتجهة إلي نيو أورلينز سوف تتأخر حوالي ساعة .
رحلة متع دلتا نمرو ثمنية و عشرين النيو أورلينس باش تتاجل تقريب ساعة.	رحلة الطيران دلتا رقم ثمانية وعشرون والمتجهة إلي نيو أورلينز سوف تتأخر حوالي ساعة .
كيف نرجع لليابان، تو نكتبلك جواب. كان عندك وقت، رجعلي.	عندما أعود ثانية إلى اليابان ، سأكتب خطاباً . وإذا كان لديك وقت ، من فضلك أرسل لي خطاباً .
وقت نرجع لليابان، باش نكتب جواب. كان عندك وقت يعيشك إبعثلي جواب.	عندما أعود ثانية إلى اليابان ، سأكتب خطاباً . وإذا كان لديك وقت ، من فضلك أرسل لي خطاباً .
خليت تذكرة متع طيارة فالهوتل.	نسيت تذكرة الطيران الخاصة بي في الفندق .
بيت عادية بلاش دوش، يعيشك.	غرفة مفردة بدون دش من فضلك .
بيت منفردة من غير دوش، يعيشك.	غرفة مفردة بدون دش من فضلك .
يعيشك كيف عاودت كلمتني. فما برشا عباد نساو ما صححوش؟	أشكرك ثانية لأنك ذكرتني . هل يميل كثير من الناس أن ينسوا توقيع أسمائهم ؟
شكراً مرة أخرى خاطر فكرتني، فما برشة مستانسين ينساو إصححو أساميهم؟	أشكرك ثانية لأنك ذكرتني . هل يميل كثير من الناس أن ينسوا توقيع أسمائهم ؟
اوكي، الوقت وفى، نواصل الحوار هاد الخميس اجاي مرة وحدة؟	حسناً . ليس لدينا وقت . هل يمكن أن نكمل هذه المناقشة يوم الخميس في الساعة الواحدة ؟
باهي. تو نكلمك كيف يحظروا.	حسناً . سأتصل بك عندما يكونوا جاهزين .
اوكي، توا كي يحظرو نكلمك.	حسناً . سأتصل بك عندما يكونوا جاهزين .
والفطور؟	ماذا عن الغداء ؟
شقولك فالفطور؟	ماذا عن الغداء ؟
حتى لوقتاش نجم نستعمل مطعم الهوتل؟	إلى متي يظل مطعم الفندق متاحا للاستخدام من قبلي ؟
هايل، اما راهو امخر. لازمني نمشي. يعيشك على السهرية.	حسنا , الوقت متأخر إلى حد ما . أعتقد أنني يجب على أن أغادر الآن . شكرا جزيلا لك على الأمسية الرائعة .
اوكي، هيا بدات طذلام، لازمني نمشي توا، يعيشك على سهرية المزيانة.	حسنا , الوقت متأخر إلى حد ما . أعتقد أنني يجب على أن أغادر الآن . شكرا جزيلا لك على الأمسية الرائعة .
نحب دجاج مصلي.	أود أن أتناول فراخ مشوية .
نحب دجاج ماشي.	أود أن أتناول فراخ مشوية .
هذه غلطتي. موش غلطتك.	إنه خطئي . ليس خطأك .
غلتي. موش غلطك.	إنه خطئي . ليس خطأك .
سامحني، وقتاش الفيلم يوفى؟	معذرة , متي ينتهي هذا الفيلم ؟
سامحني، وقتاش يكمل ال فيلم هذا؟	معذرة , متي ينتهي هذا الفيلم ؟
هذاك، يعيشك.	هذا , من فضلك .
ذهبي تسرق. نحب نعمر تقرير.	لقد سرقت مجوهراتي . أنني بحاجة لتقديم بلاغ .
دقيقة، يعيشك. تو نحطك مع سي جونس.	لحظة فقط , من فضلك . سأوصلك بالسيد جونز .
دقيقة وحدة، يعيشك. هاني بش نعديلك سي. جونز.	لحظة فقط , من فضلك . سأوصلك بالسيد جونز .
صباح الخير. معاك خطوط طيران يونايتد.	مرحبا . هذه هي الخطوط الجوية المتحدة .
عسلامة. هذي شركة طيران يونايتد.	مرحبا . هذه هي الخطوط الجوية المتحدة .
عندي اصغر منها في المودال هو بيده.	لدي واحدة صغيرة من نفس التصميم .
عند واحد صغير في نفس شكل.	لدي واحدة صغيرة من نفس التصميم .
تنجم تضيق السروال؟	هل يمكنك ترتيب هذه البناطيل ؟
تصغر السروال هاذا؟	هل يمكنك ترتيب هذه البناطيل ؟
الجمعة في الليل، الثمنية.	مساء الجمعة , في التاسعة .
هذا باب لاس فيغاس؟	هل هذه هي البوابة إلي لاس فيجاس ؟
مدخل هذا متع لاس فيغاس؟	هل هذه هي البوابة إلي لاس فيجاس ؟
عندكم كار من المطار؟	هل لديك أتوبيس من المطار ؟
عندك كار للمطار؟	هل لديك أتوبيس من المطار ؟
مغرفة أخرى، يعيشك.	ملعقة أخرى , من فضلك .
مالح شوية، أما عجبني. جبتو معك طول طريق مل يابان؟	إنها مالحة قليلا , لكنني أحبها . هل أحضرتها معك طوال الطريق من اليابان ؟
ابثه فيسع، كان ممكن.	قم بدفعها من فضلك , إن كان ذلك ممكنا .
أمان هاجموا، كان تنجم.	قم بدفعها من فضلك , إن كان ذلك ممكنا .
تنجم تصب عشرة دولار ضمان؟	هل من الممكن أن تدفع مبلغ عشرة دولارات للمقدم ؟
أي، فيقني بعد تلاثة سوايع، يعيشك.	نعم . أيقظني من النوم بعد ثلاثة ساعات , من فضلك .
زوز مغارف، يعيشك.	ملعقتين , من فضلك .
مغرفتين، يعيشك.	ملعقتين , من فضلك .
شنوة المحطة الجاية؟	ما هي المحطة القادمة ؟
عندك دواء لاوجايع المعدة؟	هل تناولت دواء لتقلبات المعدة ؟
لازمني نلبس كبوت و كرافات؟	هل أحتاج إلى أن أرتدي معطف و رابطة عنق ؟
نجم نحول فلوس لحساب الإدخار متاعي؟	هل يمكنني أن أحول أموال إلى حساب المدخرات الخاص بي ؟
نسيت ساكي.	لقد نسيت أن آخذ حقيبتي اليدوية .
نسيت ساكي.	لقد نسيت أن آخذ حقيبتي اليدوية .
انجم نعاود ناكد الرحلة.	أود إعادة التأكيد على حجز الرحلة .
نحب نعاود نأكد على رحلتي .	أود إعادة التأكيد على حجز الرحلة .
منقالتي. منقالة الكترونوك جديدة. تصنعت في سويسرا.	ساعتي . لقد كانت ساعة رقمية ماركة حديثة سويسرية الصنع .
منقالتي، كانت موديل إلكتروني سويسري جديد.	ساعتي . لقد كانت ساعة رقمية ماركة حديثة سويسرية الصنع .
نجم نمشي نتفرج في معالم المدينة مادام البابور في البورت؟	هل يمكن أن أذهب لمشاهدة المعالم أثناء رسو السفينة في الميناء ؟
لازمك تريقل الروترفزور.	من الأفضل أن تضبط المرآة العاكسة للرؤية الخلفية .
من الافظل تريغل المرييء إلي ترى بها من تالي.	من الأفضل أن تضبط المرآة العاكسة للرؤية الخلفية .
انجم نهز الصحونة؟	هل يمكن أن آخذ الأطباق الخاصة بك ؟
نكون فرحان، شنوة وقت إلي تحبو؟	سأكون سعيدا بذلك . متى ترغب في ذلك ؟
ضهرلي نسيت المصورة متاعي كيف جيت نتعشا البارح.	أعتقد أنني تركت كاميرتي وغادرت عندما كنت أتناول العشاء هنا الليلة الماضية .
نتصور إلي خليت ال كاميرا متاعي لتالي وقت فطرت هوني البارح.	أعتقد أنني تركت كاميرتي وغادرت عندما كنت أتناول العشاء هنا الليلة الماضية .
خوذهم في باب الطلوع.	اجمعهم عند البوابة .
لمهم فل مدخل.	اجمعهم عند البوابة .
اوه، لا. موش لازم. انجم نتكفل بها. عملتوا الازم.	أوه ، لا . لن يكون هذا ضرورياً . أستطيع أن اعتني به . لقد قمت بالفعل بما هو اكثر من كاف .
صلحه او بدله، يعيشك.	إما أن تصلحها أو تستبدلها ، من فضلك .
انجم الشهر الجاي.	يمكنني القيام بها في وقتا ما الشهر القادم .
نجم نعملوا ساعات شهر جاي.	يمكنني القيام بها في وقتا ما الشهر القادم .
خوذ وقتك.	من فضلك تروى .
أمان خوذ وقتك.	من فضلك تروى .
كيفاش البرودوي هذا خير من البرودوي الموجود؟	كيف يتم مقارنة هذا المنتج الجديد مع المنتجات الموجودة ؟
البياعين على محلاهم في المغازة هذه.	موظفو المبيعات في هذا المتجر لطفاء جداً .
بالله تستحفضلي على هذا؟	هلا احتفظت بهذا لي ؟
تنجم تخللي هذا؟	هلا احتفظت بهذا لي ؟
لحضة، يعيشك.	دقيقة فقط ، من فضلك .
دقيقة وحدة، يعيشك.	دقيقة فقط ، من فضلك .
معاك تساكر تسجيل الباقاج متاعك؟	هل لديك بطاقات ادعائك ؟
نحب نكري كرهبة لمدة جمعة.	أرغب في تأجير سيارة لمدة أسبوع .
ايه، اغسلهم على الاول موش مع بعضهم.	نعم , في بادئ الأمر ، اغسليها على منفصلة .
وريني مناقل رجال.	من فضلك أرني بعض الساعات الرجالي .
الاربعة و درجين.	إنها أربعة عشرة .
توا لاربعة و درجين.	إنها أربعة عشرة .
من صباح ليوم.	منذ هذا الصباح .
لازمنا نزربوا. راهم بداو يطلعوا.	من الأفضل أن نسرع . انهم يركبون بالفعل .
طلبت دجاج.	طلبت دجاجا .
طلبت دجاج.	طلبت دجاجا .
لعشرة ايام.	لمدة عشرة أيام .
إل عشرة أيام.	لمدة عشرة أيام .
الطفل هذا قداش عمره؟	كم عمر هذا الصبي ؟
قداش عمرو طفل هذا؟	كم عمر هذا الصبي ؟
بقداش للكل؟	كم التكلفة كلها ؟
قداش لكل مع بعضهم؟	كم التكلفة كلها ؟
نحب كيف هذا، يعيشك.	أريد نفس الشيء ، من فضلك .
نحب كيف هذا، يعشك.	أريد نفس الشيء ، من فضلك .
ضيعت شاكات السفر.	لقد فقدت شيكاتي السياحية .
ضيعت شيكات صفر متاعي.	لقد فقدت شيكاتي السياحية .
اعطيني دواء للقريب.	من فضلك أعطني دواء للبرد .
أمان اعطني دوا برد.	من فضلك أعطني دواء للبرد .
حط هذا في مخروط.	من فضلك ضعها في قمع .
أمان حطوا فل كون.	من فضلك ضعها في قمع .
ديمة نشوفو في تران كل يوم صباح.	أراه دائما كل صباح في القطار .
تنجم تتعشى معانا في الليل؟	هل تستطيع أن تتناول العشاء معنا هذا المساء ؟
باش نقعد فلوتيل بي لغدوة. نفرح كان تقلو الي انا في هوني.	سأقيم في فندق بي حتى غداً . أكون مسروراً إذا أخبرته أنني هنا .
باش نبقى في وتيل بي حتى لغدوة. نفرح برشة كان تقولوا ال أنا هوني.	سأقيم في فندق بي حتى غداً . أكون مسروراً إذا أخبرته أنني هنا .
اسمي شينو ياماد.	تأجلت الرحلة الجوية لمدة خمسة وأربعين دقيقة .
طيارة بش توخر ساعة غير ربع.	تأجلت الرحلة الجوية لمدة خمسة وأربعين دقيقة .
اسمي شينو ياماد.	اسمى شينو يامادا .
باش معروف المطعم هذا؟	ما هو تخصص هذا المطعم ؟
شنية إختصاص ال مطعم هذا؟	ما هو تخصص هذا المطعم ؟
كان طوابع للقريب.	فقط دواء للبرد .
جيست شوية دوا برودة.	فقط دواء للبرد .
اوه، وقيلة نظيع حوايج كل ما نسافر.	أوه ، يبدو أنني افقد شيء ما كل وقت أسافر فيه .
اه، ديما ننسى حاجة وقت نسافر.	أوه ، يبدو أنني افقد شيء ما كل وقت أسافر فيه .
معاش انجم نحرك يدي اليمين.	فقدت استخدام الذراع الأيمن .
معادش نجم نخدم ب ذراعي ليمين.	فقدت استخدام الذراع الأيمن .
عسلامة، هذا روي؟	هالو ، هل هذه تعود إلى روي ؟
لا، موش هوني. فما بلاصة آخر الكار باش تتكيف.	لا ، ليس هنا . هناك حجرة تدخين قرب مؤخرة هذه الحافلة .
لا، موش هوني. فما بيت دخان نهاية العربة هذي.	لا ، ليس هنا . هناك حجرة تدخين قرب مؤخرة هذه الحافلة .
منين انجم ناخذ سفود؟	هل لي بدليل سياحي ؟
نجم ناخو بروشيور؟	هل لي بدليل سياحي ؟
ايجا التسعة، يعيشك.	كن هناك بحلول التاسعة ، من فضلك .
ايجا غادي مع تسعة، يعيشك.	كن هناك بحلول التاسعة ، من فضلك .
ايه، يا سيد. كيفاش تحبني نقصهملك؟	نعم ، سيدي . كيف تريدني أن اقطعها ؟
أي، سيدي. كيفاش تحبني نقصو؟	نعم ، سيدي . كيف تريدني أن اقطعها ؟
شوية زيت و خل، ولاباس.	زيت و خل فقط سيكون جيداَ .
زيت و خل سافا.	زيت و خل فقط سيكون جيداَ .
عندي شنية تحب بضبط. نجم نقترح هذا؟	لقد فهمت ما أردت أنت بالضبط . هل لي أن اقترح ذلك ؟
قهوة بالسكر.	قهوة بالسكر .
قهوة مع سكر.	قهوة بالسكر .
سبعطاش ايه. اوه، سامحني. غلط.	إنها سبعة عشر ايه . اوه ، انا آسف . لقد أخطأت .
يعيشك. الى اللقاء.	شكراً لك . من فضلك عاود مرة أخرى .
كيفاش نمشي ل ديزناي لاند؟	كيف يمكنني الذهاب إلى ديزني لاند ؟
تتصور؟	أتظن ذلك ؟
سامحني. وين يجي المطعم الرئيسي؟	معذرة . أين المطعم الرئيسي ؟
سامحني. وين رستو رئيسي؟	معذرة . أين المطعم الرئيسي ؟
نحب نكلم اليابان.	أريد الاتصال هاتفياً باليابان .
نحب نعمل تليفون لل يابان.	أريد الاتصال هاتفياً باليابان .
شنوة المودال الي عندك في مخك؟	ما النمط الذي في مخيلتك ؟
شنية نوع إلي عندك في مخك؟	ما النمط الذي في مخيلتك ؟
ايه، باش نجيو الثمنية، بالوقت المحلي.	أجل . سنصل في الثامنة حسب التوقيت المحلي .
أي. باش نوصلو مع ثمانية بوقتنا.	أجل . سنصل في الثامنة حسب التوقيت المحلي .
كان تلقى حاجة، كلمني.	إن عثرت على شيء ، اتصل بي من فضلك .
كان لقيت حاجة، أمان كونتكتيني.	إن عثرت على شيء ، اتصل بي من فضلك .
انجم ناخذ سالمين و عضام؟	هل لي في شيء من لحم الخنزير والبيض ؟
الما سخون موش سخون برشا.	المياه الساخنة ليست ساخنة بالقدر الكافي .
الماء سخون موش سخون برشة.	المياه الساخنة ليست ساخنة بالقدر الكافي .
تنجم تفهمني كيفاش نعمل؟	هل يمكنك توضيح كيفية عمل ذلك ؟
تنجم تفسرلي كيفاش يتعمل هذا؟	هل يمكنك توضيح كيفية عمل ذلك ؟
بالله قيد العنوان متاعك هوني.	من فضلك سجل عنوان الاتصال بك هنا .
يعيشك إكتب أدريستك هوني.	من فضلك سجل عنوان الاتصال بك هنا .
نجم نستعمل الفلاش؟	هل يمكنني استخدام إِشارة ضوئية ؟
نجم نستعمل ل فلاش؟	هل يمكنني استخدام إِشارة ضوئية ؟
يعيشك. ارجع غدوة لبيتي في نفس الوقت. تو تلقى التصاور حاضرين.	شكراً . عد إلى غرفتي في نفس الوقت غدا . ستكون الصور جاهزة . قبل ذلك .
يعيشك. أرجع لبيتي في نفس لوقت غدوة. توا تلقى تصور حاضرين.	شكراً . عد إلى غرفتي في نفس الوقت غدا . ستكون الصور جاهزة . قبل ذلك .
أسف توا تنجم تطلب كان من مينو ليلة.	آسف فالآن لا يمكنك الطلب سوى من قائمة الطعام الليلية .
ايسانس عادي ولا نقي؟	برصاص أم بدون رصاص ؟
سونس نقي ولا غير نقي؟	برصاص أم بدون رصاص ؟
عندي وجيعة في راسي.	أشعر بصداع .
الفيزا هذه حتى لوقتاش صالحة؟	كم مدة صلاحية هذه الفيزا ؟
قداش تبقى فيزا هذي؟	كم مدة صلاحية هذه الفيزا ؟
فما سبيطار من هوني؟	هل ثمة مستشفى قريب من هنا ؟
فما سبيطار هوني؟	هل ثمة مستشفى قريب من هنا ؟
نحب كسوة.	أريد بزة .
عندك ما أطول؟	ألديك مقاس أوسع ؟
وتيل مأمن و فيه فطور صباح باهي، يعيشك.	أريد فندقاً آمنا يقدم إفطاراً جيدا ، من فضلك ؟
وين حديقة الحيوانات؟	أين حديقة الحيوان ؟
وين حديقة حيوانات؟	أين حديقة الحيوان ؟
فما وحود كبار؟	هل لديك أحجام أكبر ؟
هذا مربوط بالطقس، اما في وسط اليابان، اول افريل.	يتوقف الأمر على درجة حرارة المكان . ولكن في وسط اليابان , في أوائل أبريل .
هذا حسب سخانة ل بلاصة، أما في وسط ليابان، أول آفريل.	يتوقف الأمر على درجة حرارة المكان . ولكن في وسط اليابان , في أوائل أبريل .
تشيز برغر بالفريت.	أريد سندويتش برجر بالجبن ومقليات .
جبن و فريت.	أريد سندويتش برجر بالجبن ومقليات .
امخر على آخر ترينو.	لقد بالغ آخر قطار في التأخر .
مخر برشة ل تران لخراني.	لقد بالغ آخر قطار في التأخر .
ما عنديش صرف.	ليس معي فكة صغيرة .
معنديش صرف.	ليس معي فكة صغيرة .
خذيت تسكرة الكار؟	هل أخذت تذكرة الحافلة ؟
بالكارطة، يعشك.	البطاقة الائتمانية ، من فضلك .
كريدي، يعيشك.	البطاقة الائتمانية ، من فضلك .
كنت في رحلة طيران يونايتد نومرو ثمنمية و ثمنية و عشرين.	كنت على رحلة يونيتد إيرلاينز رقم ثمانية اثنان ثمانية .
انا في رحلة خطوط يونايتد ثمانية ثنين ثمانية.	كنت على رحلة يونيتد إيرلاينز رقم ثمانية اثنان ثمانية .
فما برشا حس بحذا بيتي.	إن حول غرفتي ضجيجا بالغا .
برشة حس بحذا بيتي.	إن حول غرفتي ضجيجا بالغا .
على الساحل الشرقي، تلقاو حتى بلايص مشهورة، كيما نيويورك، واشنطن دي سي وبوسطن.	على الساحل الشرقي ، تجد أيضاً أماكن شهيرة . مثل نيويورك ، واشنطن ، دي دي وبوسطن .
في الساحل الشرقي، توا تلقى زادة بلايص مشهورة، كيما نيو يورك، واشنطن دي سي و بوسطن.	على الساحل الشرقي ، تجد أيضاً أماكن شهيرة . مثل نيويورك ، واشنطن ، دي دي وبوسطن .
عندكم جرايد يابانية؟	هل لديك صحف يابانية ؟
عندك أوراق يابانية؟	هل لديك صحف يابانية ؟
ضاهرلي باهية.	هذا طيب ، على ما يبدو .
تحفون.	هذا طيب ، على ما يبدو .
فما دورة فل مدينة؟	هل ثمة رحلة في المدينة ؟
ايه. سامحني ما عنديش حل آخر. الدنيا امنة في الحي هذا؟	أجل . أخشى أني مضطر لذلك . ما مدى حفظ الأمن في هذه المنطقة ؟
أي. سامحني كان لازمني. فما وضع امني مليح فل بلاصة هذي؟	أجل . أخشى أني مضطر لذلك . ما مدى حفظ الأمن في هذه المنطقة ؟
اني نارى. نحب نكري سيتروان.	أفهم ذلك . أحاول استئجار سيارة سيتروين .
شفت. خترت باش نكري سيتروين.	أفهم ذلك . أحاول استئجار سيارة سيتروين .
هايل، وين الخبز؟	هذا رائع . أين الخبز ؟
هذا باهي. وين لخبز؟	هذا رائع . أين الخبز ؟
تتكيف، يعيشك. بجنب البرسانة، يعيشك.	ركن المدخنين ، من فضلك . وشباك بجوار النافذة ، من فضلك .
كيفاش تقلموا؟	كم تتقاضى نظير التفصيل ؟
عندك التريكو هذا في الوان اخرين؟	هل لديك ألوان أخرى لهذا التي شيرت ؟
ايه، باش نوصلوا عليه، نوصلو عليه.	أجل ، إننا على وشك معالجته ، على وشك معالجته .
أه، احنا جايين عليه، جايين عليه.	أجل ، إننا على وشك معالجته ، على وشك معالجته .
تو نعمل جهدي باش نهزك للسبيطار.	من الأفضل لك أن تدخل مستشفانا .
دخلت سبيطارنا بالقدا.	من الأفضل لك أن تدخل مستشفانا .
وين نلقى السوق؟	أين يمكنني أن أجد سوبر ماركت ؟
وين نلقى سبيرمرشي؟	أين يمكنني أن أجد سوبر ماركت ؟
غالي شوية، تعملي سوم؟	إنه غالي الثمن إلى حد ما . ألا يمكنك منحي خصماً ؟
غالي شوية. متنجمش تعطيني إستراحة؟	إنه غالي الثمن إلى حد ما . ألا يمكنك منحي خصماً ؟
قداش ناقفوا من مرة باش نبدل؟	كم محطة قبل التحويل ؟
قداش من ستوب حتاش نبدل؟	كم محطة قبل التحويل ؟
الراجل هذا سرقلي ساكي.	لقد سرق ذلك الرجل كيس نقودي .
راجل هذاكة سرقلي كرتابتي.	لقد سرق ذلك الرجل كيس نقودي .
الحرابش هذم باش تهضم و هذم للمعدة موش كيف كيف، موش هكا؟	حبوب عسر الهضم تختلف عن حبوب ألم المعدة ، أليس كذلك ؟
حرابش تهضيم و حرابش معدة يفرقوا، صحيح؟	حبوب عسر الهضم تختلف عن حبوب ألم المعدة ، أليس كذلك ؟
قداش تاخذ وقت على الساقين؟	كم تستغرق مشياً على الأقدام ؟
قداش وقت على سقينا؟	كم تستغرق مشياً على الأقدام ؟
باش ناخذ اكبر دبدوبات، يعشك.	سآخذ عشرين دب لعبة من أكبر حجم .
نحب ناخو عشرين دبادب كبيرة، يعيشك.	سآخذ عشرين دب لعبة من أكبر حجم .
ساهل. جيست باش نشوف فل أجندة.	الأمر يسير . سأنظر في دليل الهاتف فحسب .
نحب نقعد في البيت هذه ليلة اخرى.	أود الإقامة بهذه الغرفة ليلة واحدة أخرى .
نحب نبقى بل بيت هذي ليلة أخرى.	أود الإقامة بهذه الغرفة ليلة واحدة أخرى .
سامحني، أما نحب نسلم التقرير المسروق.	معذرة . ولكني أريد تسليم تقرير السرقة .
اي باهي، هذا مربوط بالتراسبور الي باش تاخذه. ماشي بالكار والا بالطيارة؟	حسنا ، الأمر يتوقف على وسيلة المواصلات التي تأخذها . هل ستذهب بالحافلة أم الطائرة ؟
باهي، سا ديبون ول ترنسبور إلي خديتو. باش تمشي بل كار ولا بي طيارة؟	حسنا ، الأمر يتوقف على وسيلة المواصلات التي تأخذها . هل ستذهب بالحافلة أم الطائرة ؟
يقلقك كان نقعد هوني؟	هل تمانع في جلوسي هنا ؟
نجم نبعث مايل بدولار؟	هل يمكنني أن أرسل أي ميل واحد فقط قيمته دولار .
ايه، طلعهم للبيت الف و متين و اربعة و ثلاثين.	أجل ، من فضلك أرسله إلى الغرفة اثنا عشر أربعة وثلاثون .
أي، يعيشك ابعثوا لفوق لبيت ثناش أربعة و تلاثين.	أجل ، من فضلك أرسله إلى الغرفة اثنا عشر أربعة وثلاثون .
في اما وقت لازمني نكون في المطار؟	متى يتعين على الوصول إلى المطار ؟
وقتاش لازمني نجي لل مطار؟	متى يتعين على الوصول إلى المطار ؟
هذا رزين.	هذه السرعة بطيئة .
سامحني التواليت ما يخدمش. عاوني.	آسف الحمام به عطل . أحتاج للمساعدة .
سامحني التوالت مايمشيش. نحب شخص يعاوني.	آسف الحمام به عطل . أحتاج للمساعدة .
باش نهزك لبالصتك. هن هوني، يعيشك.	سأذهب بك على مقعدك . من هنا ، من فضلك .
نحطك في بلاصتك. منا، يعيشك.	سأذهب بك على مقعدك . من هنا ، من فضلك .
سامحني، نجم نسالك سؤال؟	معذرة ، هل يسعني أن أتوجه إليك بسؤال ؟
سامحني، نجم نسئلك؟	معذرة ، هل يسعني أن أتوجه إليك بسؤال ؟
نتصورصحيح.	أعتقد ذلك .
نتصور.	أعتقد ذلك .
صباح الخير، تشرفت بمعرفتك.	أهلا . فرصة سعيدة .
نحب نسجل الباقاج هذا لطوكيو، يعيشك.	أريد فحص هذه الحقائب المتجه إلى طوكيو , من فضلك .
نحب نسجل الدبش هذا ال طوكيو، يعيشك.	أريد فحص هذه الحقائب المتجه إلى طوكيو , من فضلك .
تجم توريني واحد آخر اكبر شوية؟	هل يمكنك أن تريني حجماً أكبر بقليل ؟
تنجم توريني واحد ماكبر شوية؟	هل يمكنك أن تريني حجماً أكبر بقليل ؟
لقيت كون الدبش الي تصنعو في اليابان مقصوصين بالباهي.	أظن أن الملابس المصنوعة في اليابان قد جرى تفصيلها على نحو أفضل بالتأكيد .
نتصور حوايج مخيطة أحسن خياطة فل يابان.	أظن أن الملابس المصنوعة في اليابان قد جرى تفصيلها على نحو أفضل بالتأكيد .
كان باهي تستسلم.	الأجدر بك أن تكف عن ذلك .
كان باهي تستسلم.	الأجدر بك أن تكف عن ذلك .
نجم تتقيدلي الادريسة و نومرو التالفون، يعيشك؟	هل يمكنك تسجيل العنوان ورقم الهاتف من أجلي ، من فضلك ؟
تنجم تكتبلي لدريسة و نومرو تليفون، يعيشك؟	هل يمكنك تسجيل العنوان ورقم الهاتف من أجلي ، من فضلك ؟
مسخن؟	هل بها جهاز تدفئة ؟
باش نسافر من اما مطار؟	من أي المطارات سأغادر ؟
أماهو مطار باش نخرج منو؟	من أي المطارات سأغادر ؟
مخذيتش تعمر المعلومات في الطيارة؟	ألم تتلق الاستمارة بالطائرة ؟
عطاوك لورقة في طيارة؟	ألم تتلق الاستمارة بالطائرة ؟
نحب حديد حوايج.	أريد مكواة .
نحب على حديد حوايج.	أريد مكواة .
يعشك كيف شركتنا افكارك الباهية.	شكراً على إدلائك بأفكارك الفريدة معنا .
نمشي ل سكي مرتين في الشهر في الموسم.	إني أتزلك مرتين في الشهر خلال الموسم .
تولدت في واحد أفريل عام الف و تسعمية و خمسة و خمسين.	ولدت في أول أبريل سنة ألف وتسعمائة وخمس وخمسين .
تولدت نهار واحد آفريل الف و تسعة ميا و خمسة و خمسين.	ولدت في أول أبريل سنة ألف وتسعمائة وخمس وخمسين .
هذه كار تدي لوسط البلاد؟	أهذه هي الحافلة التي توصل إلى وسط المدينة ؟
هذي لكار صحيحة الوسط ل بلاد؟	أهذه هي الحافلة التي توصل إلى وسط المدينة ؟
بقداش اللفاح هذا؟	بكم هذا العطر ؟
قداش بارفان هذا؟	بكم هذا العطر ؟
ل شنوا معمول؟	ما الغرض منها ؟
منين نعدي الاجراءات الرسمية؟	أين يمكنني أداء الإجراءات الرسمية ؟
كلم الامبلونس.	من فضلك استدع سيارة إسعاف .
يعيشك كلم لمبيلونس.	من فضلك استدع سيارة إسعاف .
فما تقدم؟	كيف تسير الأمور ؟
يوم الدستور او كيمبو كينين بي، تعملت نهار ثلاثة ماي، ن هار راحة يحتفلوا بيه بالدستور الياباني الحالي.	"عيد الدستور أو "" كيمبو كينينبي "" عطلة قومية في الثالث من مايو للاحتفال بذكرى وضع الدستور الياباني الحالي ."
الثنية هذه فيها طلة على بنية سايس؟	هل تشمل هذه الرحلة زيارة لبرج سيرز ؟
رحلة هذي فيها ماشية لسيرس تور؟	هل تشمل هذه الرحلة زيارة لبرج سيرز ؟
فما مكتبة قريبة من هوني؟	هل ثمة محل قريب لبيع الكتب ؟
فما مكتبة هوني؟	هل ثمة محل قريب لبيع الكتب ؟
باش نعمل قراية في الصيف في جامعة هاواي.	سأحضر المدرسة الصيفية بجامعة هاواي .
منين متعدين احنا توا؟	ما هذا المكان الذي نمر به الآن ؟
زوز كبار و صغير عمره ثلاثة سنين.	اثنان كبار وطفل عمره ثلاث سنوات .
زوز كبار و طفل عمرو تلاثة سنين.	اثنان كبار وطفل عمره ثلاث سنوات .
في تواليت في محطة الترينو.	في غرفة انتظار بالمحطة .
في تواليت في المحطة.	في غرفة انتظار بالمحطة .
