هوذاك هاناك، قبال مكتب المعلومات السياحيه بالضبط.	هناك ، أمام بيانات السائح تماما .
ماقد سمعتش ابدا بهذا العنوان هانا.	لم اسمع بهذا العنوان من قبل بالقرب من هنا .
امشي طوالي لوما تبسر صيدليه.	استمر في السير في هذا الطريق حتى تجد صيدلية .
بكم هو الصبوح؟	كم تكلفة الإفطار ؟
كيف اقدر اساعدك؟	كيف أستطيع مساعدتك ؟
اخطى يسار عند الركن الثالث.	اتجه يسارا عند الناصية الثالثة .
تشتي كريمه وسكر في القهوة؟	هل تحب أن تضع قشدة وسكر في قهوتك ؟
اين هو الكافيه؟	أين المقهى ؟
أشتي سترة أطفالي.	أريد جاكيت للأطفال .
تمام. يكلف خمسه وثمانين سنت للبريد العادي و ثلاثه دولار بالضبط زياده للتوصيل الخاص.	حسنا . إنها تتكلف خمسة وثمانون دولارا في البريد العادي وثلاثة دولارات في التوصيل الخاص .
هل شا اواجه مشاكل مع الجمارك؟	هل لديك أحذية حريمي عند أصابع القدم ؟
لا. ممكن اقترح عليك غرفة مزدوجة ل استخدام فرد بدله؟ عندنا واحدة.	لا ، هل لي أن أقترح أخذ غرفة ذات سريرين للاستخدام الفردي ؟ فنحن لدينا واحدة .
اشتي تجعيد قوي، لو سمحت.	أريد تمويج متقارب لشعري ، من فضلك .
هي تشتي بيره.	هي تريد بيرة .
صباح الخير. كيف حالك؟	صباح الخير . كيف حالك .
أسف مضطر اطلب منك تبرز اي شي يثيت هويتك.	أسف أنني بحاجة إلى أن أطلع على أي مستند لتحديد الهوية .
ما هو نوع الصوص؟	أي نوع من الملابس ؟
أنا بخير. لكن ممكن تتصل لصاحبي؟	أنا بحالة جدية ، لكن هل تمانع في الاتصال بصديق ؟
من هو أعز أصحابك؟	من هو أفضل صديق لك ؟
يوم الصحة والرياضه عشره اكتوبر هو اجازه وطنيه عملوها عسب يشجعو الناس يهتمو بصحتهم.	يوم الصحة الرياضية هو يوم العاشر من أكتوبر وهو إجازة قومية الغرض منها تحسين صحة المواطنين .
عتقدر تساعدني القى شنطتي؟	هل لك أن تساعدني في الوصول إلى حقيبتي ؟
به احد بيساعدني. شكرا.	تقدم إلىّ المساعدة ، شكراً لك .
لوما قدك هناك، اسال احد ثاني، لو سمحت.	عندما تصل هناك أسأل شخص آخر ، من فضلك .
هولا اثنين دولار. خلي الباقي.	تفضل هذان دولاران . احتفظ بالباقي .
كم ب تشل على العمليه؟	كم تتقاضى لتطبيع صور الفيلم ؟
احنا الأثنين نشتي ندفع حق وجباتنا.	كلا منا يريد أن يحاسب على وجبته .
الموقع كان فوق كرسي في اللوبي.	المكان كان على كرسي في البهو .
اشتي قاموس جيب، لو سمحت.	أريد قاموس جيب ، من فضلك .
لشخصين الساعه سبع. الاسم هو وطنابي.	لشخصين عند الساعة السابعة , الاسم وتاناب .
ساعتي. كانت سايكو رقميه.	ساعتي . كانت ساعة سيكو رقمية .
أين محل الهدايا؟	أين محل الهدايا ؟
ممكن منبه، لو سمحت.	أريد منبه ، من فضلك .
معظم اليابانيين ياكلو اخطبوط و حبار.	معظم اليابانيين يأكلون الأخطبوط والحبار .
ممكن تقطع تذكرتين درجه ثانيه ل شيكاغو، لو سمحت؟	هل يمكنني الحصول على تذكرتين درجة ثانية لشيكاغوا , من فضلك ؟
ماهو رقم الرحله؟	ما هو رقم الرحلة الجوية ؟
لحوالي ايام قليله.	لعدة أيام قليلة .
الثاني على اليسار.	الثاني من على اليسار .
هذا مكتب الاستقبال؟ به هانا عياده قريبه؟	هل هذا مكتب الاستقبال ؟ هل يوجد عيادة قريبة ؟
هذا طعمه غريب.	أنه ذو مذاق غريب .
أيوة. راعي، شا ادي لك واحده.	نعم . انتظر , سوف احضر لك واحدة .
نص القاروره، لو سمحت.	نصف زجاجة , من فضلك .
أنت بتدور على حاجه؟	هل تبحث عن شيء ما ؟
أربع ليالي.	أربع ليالي .
أشتي شويه شرابات.	أريد بعض الجوارب الرجالي .
ممكن ترخصه لأنه به شويه بقع؟	هل تستطيع أن تخفض سعرها لوجود بعض البقع بها ؟
رجال صدمني. وبعدها ركزت انه محفظتي أختفت.	ارتطم بي شخص وبعد ذلك اكتشفت أن محفظتي قد سرقت .
مش أنا متأكد اذا انا وكفت ملابس لرحله ثلاث أسابيع.	أنا غير متأكد إذا كنت قد حزمت ملابس كافية لرحلة مدتها ثلاثة أيام .
اذا احد سأل عليا، قلهم ان انا شا اكون في الكافيه.	إذا سأل أحد عني فأخبره بأني سوف أكون بالمقهى .
أنا متأكد انه كان في الجيب الداخلي في الكوت حقي.	أنا متأكد أني وضعتها بالجيب الداخلي للمعطف .
عتدفع لي شركه الطيران لشروة احتياجاتي الشخصية؟	هل ستدفع لي شركة الطيران لشراء بعض الاحتياجات الشخصية الأساسية ؟
أشتي غرفة مع حمام.	أرغب في غرفة بحمام .
به واحد فتح حقي الطرد.	شخص ما فتح الطرد الخاص بي .
أحتاج اشتري شامبو.	أرغب في شراء شامبو .
ممكن تقول لي لوما نوصل مركز سيفيك؟	هل بإمكانك أن تخبرين متى نصل إلى مجمع الخدمات العامة .
أين هو أقرب جزار؟	ـ أين أقرب محل جزارة ؟
أشتي اجلس لمده اربع ليالي من أول أغسطس.	نرغب في أن نقيم أربع ليالي بدءاً من أول أغسطس .
ما أسم هذيك الورده؟	ما اسم هذه الوردة ؟
خمسطاعش سبتمبر هو يوم احترام المسنين.	الخامس عشر من سبتمبر يوم احترام المسنين .
ممكن تغير الصياغه للذي عادك قلتهن؟	هل يمكنك أن تغير الصياغة طبقاً لما قلته للتو ؟
ممكن تتحاكى بصوت اعلى شويه، لو سمحت؟	لا أستطيع أن أفعل ذلك , لكني سوف أضعها في الحقيبة لك .
كم عيشل وقت قبل ما يخرج؟	كم تستغرق حتى تصبح متاحة .
أين هن معلومات الرياضة؟	أين الاستعلامات الرياضية ؟
هذا المقاس، اللي انتو تسموة مقاس عادي، يفي بالغرض.	هذا المقاس ، الذي تسميه المقاس العادي ، سوف تجده هنا .
متى اغير القطار عسب اوصل ايدنبره؟	من أي مكان يمكنني أن أغير القطار الذي يوصلني إلى إدنبره ؟
أشتي اطرح هذا بصندوق امانات.	أود أن أضع ذلك في صندوق ودائع آمن .
أين شا اقدر اصرف زلطي؟	أين يمكنني تغير نقودي ؟
بين اتساءل حق ماهي القيمه اللي بالفاتوره.	أتساءل عن هذه الرسوم الزائدة على فاتورتي .
أنا شا ادفع خمسين دولار.	أنا سوف أدفع خمسون دولاراً .
الان انا داري ما كان الغلط.	الآن أعرف . ماذا كان الخطأ . ؟
كم اقدر اشل اوقيه عطر من غير جمركه؟	كم أوقية من العطر أستطيع الحصول عليه من غير رسوم ؟
فقط سياحه.	فقط سياحة .
هذا تمام، لو سمحت وقعهن. كيف تشتيه يوقع؟	هذا جيد , من فضلك وقع عليهم . كيف تريدها ؟
اشتي واحده كبيره.	أود الحصول على واحدة كبيرة .
أنا مصور مستقل.	أنا مصور حر .
التجار يقدرو يبدلو لك الدولارات؟	يستطيع الصرافون أن يغيروا دولاراتك من أجل بقشيش الكازينو . هل نذهب ؟
انا معي لك الطلب الاسبوع الجاي.	سوف أحضر لك العرض الأسبوع القادم .
انا لازم اخطى. شا اتصل بك بعدين.	علىّ أن أذهب ، سأتصل بك لاحقاً .
أشتي شويه حفاظات.	أريد بعض الحفاضات التى يمكن التخلص منها بعد الاستعمال .
اين كانين بينشأين اسماك الفراشة؟	أين نشأت سمكات الفراش هذه ؟
ممكن تصرفهم لي دولارات، لو سمحت؟	هل لك أن تغيرهم إلى دولارات من فضلك ؟
احنا محظوظين. معاهم قطعه واحده مقاس اربعه في محل الاا موانا.	نحن محظوظون جداً . لديهم واحدة مقاس أربعة فى متجر ألامونا .
أفضل غرفة هادئه.	أُفضلُ حجرة هادئة .
أشتي شويه مزيل طلاء الاظافر.	أريد مزيلا لطلاء الأظافر .
أشتي بطاريه.	أريد بطارية .
هذه الشنطه مناسبه لكل الاجواء؟	هل هذه الحقيبة مناسبة لكل حالات الطقس ؟
أشتي استاجر سيارة توماتيك ل يومين.	أريد تأجير سلاح آلى لمدة يومين .
فاتتني رحلة عشرين حق سان فرانسيسكو.	لم أدرك الرحلة رقم عشرون المتجهة إلى سان فرانسيسكو .
بكم للمطار؟	كم سأدفع للوصول إلى المطار ؟
هذا تمام. ايحين هو؟	هذا جيد . متى هو ؟
كم عمر بنتك؟	كم عمر ابنتك ؟
عتقل لي على بعض الفنادق الرخاص والنظاف؟	هل يمكن أن تدلني على بعض الفنادق الرخيصة والنظيفة ؟
عنقدر نحجز لك غرفه مريحه في قلعه قديمه قريب من ملعب جولف مشهور.	يمكننا ان نحجز لك غرفة مريحة في قلعة قديمة بالقرب من نادي جولف شهير .
انا انصحك ب هذا لانه معمول ميه بالميه من مكونات طبيعيه.	ارشح ذلك لأنه مائة في المائة مصنوع من مكونات طبيعية .
ممكن تقل لي اين اقدر القى سياره اجره؟	هل من الممكن أن تخبرني أين أستطيع أن أحصل على تاكسي ؟
تذكرتين درجه ثانيه، لو سمحت.	تذكرتين درجة ثانية من فضلك .
أشتي ارسل فاكس.	أود أن أرسل فاكس .
اشتي كاويه سفري.	أريد مكواة سفر .
أقدر اقدم لك أي شي؟	أيمكنني أن أقدم لك أي شيء ؟
اشتي واحد الذي يسع حجم الورق الطبيعي للرسايل بدون ما يتعطفين.	أريد الشخص الذي يعد وثائق عادية في حجم ورقة الخطاب بدون الحاجة إلى طيهم .
أنا اتحسس من القطط.	أنا شديد الحساسية للقطط .
ايوة، ضروري يكون معك رخصه قياده و، ااه، ضروري يكون معك ترخيص من لجنه تاكسي وليموزين.	نعم , لا بد أن يكون عندك رخصة قيادة ، ولا بد أن تحصل على رخصة من لجنة التاكسي والليموزين .
اتفضل، سيدي.	استمر يا سيدي .
تشتي تجي تتسوق معي بعد الظهر؟	هل تريد أن تذهب للتسوق معي بعد الظهر ؟
الان، اتصالك بدا. لو سمحت اتفضل.	الآن ، مكالمتك ردت . تفضل من فضلك .
ما هو التذكار النموذجي ل هاواي؟	ما التذكار الخاص بهاواي ؟
أقدر اسير لاهاناك بمترو؟	أيمكنني أن أذهب هناك بمترو الأنفاق ؟
أشتي مجفف شعر.	أريد مجفف .
عنقدر نوصل اي بقعه واحنا بنتحاكى هكذا؟	هل نذهب إلى أي مكان متحدثين مثل ذلك ؟
بالتأكيد. خليني ابسره. انت اوتجعت بالمرجان، اعتقد.	بالتأكيد . دعني أراها . أظن أن المرجان جرحك .
به طريق سريع؟	هل هناك طريق حر ؟
أسف، شليت الرقم الغلط.	آسف , لقد اتصلت بالرقم الخطأ .
اقدر القى تذكرتين للمسرحيه الموسيقيه للجمعه الجايه؟	هل أستطيع أن الحصول علي تذكرتان للمسرحية الغنائية الجمعة القادمة .
أقدر امدد جلستي؟	هل أستطيع تمديد إقامتي ؟
ممكن تقول لي لمن تلتقي الشنطه الضايعه؟	هل من الممكن أن تخبرني عندما تعقروا علي الحقيبة الضائعة ؟
ما بيسمو الحديقة الوطنية؟	ما اسم هذه المحمية ؟
ممكن شويه فواكه؟	هل من الممكن أن احصل علي بعض الفاكهة ؟
اقدر اتغدى الان؟	هل أستطيع تناول غذائي الآن ؟
اشتي اصرف هولا الدولارات.	أريد أن أستبدل تلك الدولارات .
مش هي تفاحه لكن هي فرسك.	هذه ليست تفاحة ولكنها خوخة .
شا ادي لك رشده. شلها للصيدليه.	سوف أعطيك روشتة . خذها إلى الصيدلية .
معانا رحلات ثلاث مرات بالاسبوع، الثلوث، الجمعه، و السبت.	نسافر جواً ثلاث مرات في الأسبوع ، أيام الثلاثاء والجمعة والسبت .
ايوة، معانا هذا. احنا عنجهزه لك الان.	نعم لدينا هذا ، سوف نجهزها لك .
انت امريكي؟	هل أنت أمريكي ؟
سيارتي موقفه.	لقد تعطلت سيارتي .
أين هو ظل العيون؟	أين مظلل العيون ؟
نشتي زووه هادئه، اذا امكن.	نريد ركناً هادئاً ، إن أمكن .
ذيه التاكسي فاضي؟	هل هذه السيارة الأجرة متاحة ؟
هذه محطة اكسبريس؟	هل هذه محطة قطار سريع ؟
اوه. اقدر أتغدى بعدين؟ ما بين احسش ان انا بخير الان.	آه . هل يمكنني الحصول على وجبتي فيما بعد ؟ أنا أشعر أنني لست على ما يرام الآن .
في الواقع، معي لكم خبر. قد انا شا اتزوج.	بالفعل لدي أخبار . أنا سأتزوج .
واحد اقتحم غرفتي ليله امس.	اقتحمت غرفتي الليلة الماضية .
ابسر التعليمات اللي فوق غلاف الاكل المفرغ من الهواء.	انظر التعليمات على علبة الطعام الفارغة .
مابش معك دروس تجريبيه؟	أليس لديك دروس تجريبية ؟
من اين اقدر اشتري طوابع البريد؟	أين يمكنني أن أشتري طوابع بريد ؟
انا من بريطانيا العظمى.	أنا من بريطانيا العظمى .
لازم اسال مرتي على هذا.	علي أن أفحص ذلك مع زوجتي .
اشتي ترجع لي الزلط حق هذا.	أريد أن أحصل على تعويض لذلك .
به هناك كبينه اتصالات قبال البنك ذياك.	يوجد صندوق للهاتف أمام هذا المصرف .
انا شا اوصل على تسعه مارس وارح لي على اربعطعش.	سأصل في التاسع من مارس وأغادر في الرابع عشر .
معك البقيه؟	هل لديك كعب ؟
اين هي محطه الباص؟	أين المحطة النهائية للحافلة ؟
بيعجبك الحالي؟	هل تريد بالحلويات ؟
انت تتكلم؟	هل تتحدث ؟
نفس الشي لي، لو سمحت.	الشيء نفسه لي ، من فضلك .
طلبي ماقد وصلش.	طلبي لم يأت .
به ينابيع حاميه ملان.	هناك الكثير من الينابيع الحارة .
لو سمحت اصرف خمسين الف ين ل دولار امريكي.	من فضلك غير خمسين آلاف ين إلى دولارات أمريكية .
هذا عادي عندي. اصلا اشتي اشقر.	هذا حسن بالنسبة لي . في الواقع أحب أن أدخن .
اشتي قلص نبيذ احمر.	أريد كوباً من الخمر الأحمر .
الا اذا هو حقك، يا سيدي. ههههه، هي الا نكته.	فقط إذا كانت ملكك ، سيدي . هاها ، مزحة صغيرة .
طبعا. كيف اقدر اخدمك؟	بالتأكيد . كيف يمكننا خدمتك ؟
البطاقة. ها، صح. الجواز ينفع؟	تحقيق شخصية . آه ، هل جواز السفر ينفع ؟
شا ابسر اذا اي واحد من هولا عيضبط.	سأرى ما إذا كان أي منها يناسبني .
اشتي كتلي.	أريد غلاية .
ممكن تخليه يرجع يتصل بي؟	هل لك أن تطلب منه أن يعاود الاتصال بي ؟
طيب ليش؟	لماذا إذاً ؟
عفوا. به مكتبه قريبه من هانا؟	عذراً . هل يوجد محل كتب قريب من هنا ؟
الباص هاناك.	الحافلة هناك .
اشتي لفتين من ايزو ميه، فلم ملون، وسته وثلاثين لقطه، لو سمحت.	أريد لفتان من ISO مائة ، فيلم ملون ، ستة وثلاثين لقطة ، من فضلك .
اشتي اصرف هذا الشيك ب سبعين دولار.	أود أن أصرف هذا الشيك بسبعين دولاراً .
اشتي اشتري طوابع لعشره بطاقات بريديه لليابان، لو سمحت.	أود أن أشتري طوابع لعشرة بطاقات بريدية إلى اليابان ، من فضلك .
به اي بنك قريب من المحطه؟	هل توجد مصارف بالقرب من المحطة ؟
انا خايف او هذه غلطه بالفاتوره.	أخشى أن يكون هناك خطأ في الفاتورة .
واحد برجر بالجبنه، لو سمحت.	واحد شيزبرجر لكي أذهب ، من فضلك .
اجري.	أجري .
عتقدر تسلفني كيبل معزز؟	هل يمكن أن تقرضني سلك إمداد ؟
اديلي ذيك لحم الخنزير، بس مش ثخين مثل هذاك*.	أعطني قطعة لحم الخنزير هذه ، ولكن ليس بسمك تلك .
احنا عنجي على سبع.	سنأتي في السابعة .
ايسكريم بالفانيليا ابو بسكت، لو سمحت.	مخروط من الأيس كريم الفانيليا ، من فضلك .
أنا معك. قدوة الان طبيعي قوي.	أوافق . يجب أن تصبح طبيعية جداً .
اوبه من الحفره، اوبه من الحفره، وبعدين قريب من الابواب، لو سمحت.	لاحظ الفجوة ، لاحظ الفجوة ، ثم قرب الأبواب ، من فضلك .
شا احتاج بطاقة الائتمان.	سأحتاج إلى بطاقة ائتمان .
لو سمحت اديلي تقرير عن الحادث.	من فضلك أعطني تقريراً عن الحادث .
لا، شكرا بس الان.	لا ، أشكرك حالياً .
تمام، لو سمحت اجلس على الخط. السيد ناكاجيما، السيده سايتو سكلهم ما بيجاوبو على الاتصال؟ تشتيني اتصل لهم بعدين؟	حسنا ، ابق على الخط . سيد/ ناكاجيما ، الآنسة/ سايتو يبدو أنها لا ترد على المكالمة . هل تريدني أن أتصل عليها فترة أطول ؟
اين استلام الشنط حق رحله سبعه صفر ثلاثه؟	أين بيان أمتعة الرحلة سبعة صفر ثلاثة ؟
به حاجه غلط ب شنطتك.	شيء خطأ مع حقيبتك .
عيخرب ذيه؟	هل هذا سيفسد ؟
لا، شكرا. احسن لو ما ازيدش اشرب بعد الان.	لا ، شكراً . من الأفضل أن لا أشرب المزيد .
لو سمحت قل لي على بعض الشوارع المريحه للتسوق.	من فضلك أخبرني عن بعض الشوارع المناسبة للتسوق .
انا اقدر الموسيقى الكلاسيكيه تقدير عظيم.	لدي تقدير كبير للموسيقى الكلاسيكية .
تمام. ما اسم جهة الاتصال حقك وكم رقمها، لو سمحت.	حسنا . ما هو اسم شريكك ورقمه ، من فضلك .
عفوا. خليني اخرج، لو سمحت.	عذراً . دعني أخرج ، من فضلك .
ممكن تتصل بموظف بيتحاكى ياباني؟	هل يمكنك أن تستدعي موظفاً يتحدث اليابانية ؟
احنا ب نزور اقاربنا اكثر الاحيان.	نزور أقاربنا كثيراً إلى حد ما .
ميكي هاياكاوا. هذه غرفة سبعه صفر اثنين.	ميكي هاياكاوا . هذه غرفة سبعة صفر اثنين .
ما ينفعش يكون طويل. خمسطاعشر دقيقة بالكثير.	يجب أن لا تكون طويلة . خمسة عشر دقيقة في الأغلب .
ممكن تقل لي كم هي تكلفه الاتصال؟	هل يمكنك أن تخبرني بقيمة هذه المكالمة ؟
به جولة سياحية الصبح؟	هل توجد أية جولة صباحية ؟
انت بتصرف عملات اجنبيه؟	هل تغير عملات أجنبية ؟
من اين شا اقدر اشتري لفه فلم؟	أن يمكنني أن أشتري لفة من الفيلم ؟
معك يبره يابانيه؟	هل لديك بيرة يابانية ؟
اشتي اسجل شنطي.	أريد تسجيل أمتعتي .
عفوا.	مرحباً بك .
دقيقه، لو سمحت.	لحظة من فضلك .
من امس.	منذ أمس .
به تامين يشمل الصدمات والمسئولية القانونية.	تشمل تأمين ضد التصادم والدين .
معك اي بروشات بتصاميم حاليه؟	هل لديكم دبابيس زينة ذات تصميمات رائعة ؟
انا بين اتصل لك من كشك عام في ماسي.	إنني أتصل من كشك عمومي في ماسي .
كم قيمه الموقف بالساعه؟	كم أجر الانتظار في الساعة ؟
سيداتي وسادتي، في رحلتنا اليوم، معانا حضور يابانيين تقدرو تتعرفو عليهم بالاوسمه اللذي هم لابسين لها. اذا تعرفو احد يحتاج اي مساعده باللغه، لو سمحتو قولو لنا.	سيداتي سادتي ، لدينا على متن رحلتنا اليوم مضيفين يتحدثون اليابانية يمكن التعرف عليهم من خلال الشارة التي يلبسونه . إذا كنت تعرف أي شخص يريد مساعدة في الترجمة ، من فضلك دعنا نعرف .
هل به اي فتره فنيه محدده تفضلها؟	هل توجد أي حقبة معينة للفن تفضلها ؟
امشي طوالي على طول النهر حوالي نص ميل. انت عتوصل للحديقه.	سر في خط مستقيم على طول النهر حوالي نصف ميل . ستصل للمتنزه .
حاضر، شا ارسلهن لك ل لاس فيغاس.	حسناً ، سأرسلها لك إلى لاس فيجاس .
بين ادور على فنايل للجري.	أبحث عن قميص للجري .
تشتي اي شي تشربه من البار؟	هل تود شرب شيئاً من الحانة ؟
احسن لك سير بقطار ثمانيه وثلاثين.	من الأفضل أن تستقل قطار الثامنة والنصف .
الان هو موسم المحار، عيوقعين حاليات.	الآن موسم جمع المحار ، لذلك سيكونون في حالة جيدة .
شا اخرج حوالي الساعه تسع بالعشيه.	سأقوم بتسجيل الدخول في تمام الساعة الثامنة مساءاً تقريباً .
قدوة متاخر. ضروري اخطى.	الوقت يتأخر . يجب أن أرحل .
ماقد استخدمت خدمه الغسيل حقك. ممكن تبسره مره ثانيه؟	لم أستخدم خدمة الغسيل عندكم . أيمكنك التحقق مرة أخرى ؟
اشتي شاهي، لو سمحت.	أريد شاي من فضلك .
ماشي، مابش.	كلاً ، لا يوجد .
هذه اخر نقطه؟	هل هذه هي آخر محطة ؟
هيا نتصله.	لنتصل به .
ذيه البسباس فح؟	هل هذا المتبل حار ؟
من اين اقدر الاقي باص السياحه؟	أين يمكنني أن أستقل حافلة لمشاهدة المعالم ؟
ايوة، اشتي ابسر معالم المدينه.	أجل ، أريد مشاهدة معالم المدينة .
شكرا لكم على ضيافتكم.	شكراً على كرم ضيافتك .
الامانه احسن سيايه.	الأمانة هي السياسة المثلى .
تقدر تقومني الساعه ست، لو سمحت؟	هل لك أن توقظني في تمام السادسة من فضلك ؟
كم عتكلف ل نص يوم؟	كم السعر لنصف يوم ؟
انا كنجي.	أنا كينجي .
طيب، اذا انتو الاثنين اصريتو، شا اجي معاكم.	حسناً ، في حالة إصرار كليكما , سأذهب معكما .
صندوق الامانات، لو سمحت.	خزينة الودائع , من فضلك .
ضروري ادفع حق البترول؟	هل مطلوب منى دفع ثمن الغاز ؟
سارق. امسكه.	لص . أمسكوا به .
لو سمحت اديلي فكه.	من فضلك أعطني بعض النقود الفكة .
هي صغيره و حاليه.	إنها صغيرة الجسم وذكية .
مقلي، لو سمحت.	مقلي من فضلك .
بالمناسبة، انت فاضي السبت الجاي؟	على فكرة , هل أنت غير مشغول السبت القادم ؟
طيب، اذا، يمكن نوقع جمعه سابرين.	حسناً ، إذن , ربما سننسجم مع بعضنا .
عاملتني وكأن انا كنت شحات.	إنها عاملتني كما لو كنت متسولاُ .
بين ابسر. والكل، تقدر تساعدني بمشكله ثانيه؟	أفهم . هل يمكنك مساعدتي في هذا المشكلة الأخرى أيضاُ ؟
ممكن تطرح عدسات موصوفه طبيا ل هولا النظارات الشمسية؟	هل يمكنك وضع عدسات نظر في هذا النظارة الشمسية ؟
كلب حالي. ما فصيلته؟	يا لها من كلاب ذكية . من أي فصيلة ؟
نكعت الشوكه حقي. لو سمحت ادي واحده غيرها.	وقعت منى الشوكة . من فضلك أحضر واحدة أخرى .
كان ممتع.	كان هذا ممتعاً .
اكيد. اخطى طوالي ولف يمين عند الركن الثالث. عتلاقيه على يمينك.	بالتأكيد . سر في خط مستقيم ثم اتجه يميناُ عند الناصية الثالثة . ستجده على يمينك .
تعرف كاثي؟ هذه حفله عيدميلادها.	أتعرف كاثي ؟ إنه عيد ميلادها .
عندك تدرجات الالوان؟	هل لديك لوحة موضوع عليها الألوان ؟
لكن، هو، يا رجال، كيف اعرف انه هذا هو الصدق؟	لكن ، هو , يا رجل كيف أعرف أنه الشيء الحقيقة ؟
اقدر احصله بدون ضرايب؟	هل يمكنني شرائها معفاة من الضرائب ؟
مقدرش اطرح شنطي تحت الكرسي. تقدر تخليهن عندك، لو سمحت؟	لا يمكنني وضع الأمتعة تحت المقعد . هل لك أن تحتفظ بها لأجلي من فضلك ؟
ممكن تطرح لي الشنطه في شنطة السيارة؟	هل يمكن أن تضع حقيبة السفر هذه في صندوق السيارة .
انا شا اخرج الان، يعني شا اشله.	أنا خارج الآن . لذلك سآخذها .
اين هو الاصنصير؟	أين المصعد ؟
به احد يقدر يعزف بيانو؟	هل يوجد أحد يستطيع العزف على البيانو ؟
شكرا لك، بس اعتقد انه مابش وقت عسب اجلس ليلتين. ممكن تحجز لي غرفه مزدوجه في هذاك الفندق ل ليله اثناعشر مارس بس؟	شكراً . لكنني لا أعتقد أن عندي وقت للإقامة لمدة ليلتين . هل يمكنك حجز غرفة بسريرين لي في ذلك الفندق ليلة الثاني عشر من مارس فقط ؟
عادوة ماقد قررناش.	لم نقرر بعد .
صاحبي ادرب وعسف كاحله.	تعثر صديقي والتوي كاحله .
شا اجرب شويه شربات.	سأجرب بعضاً من الشراب المثلج .
به هانا مطعم تايلندي قريب؟	هل يوجد مطعم تايلاندي قريب من هنا ؟
هو على اليمين بعد العماره الطويلة. يعني، ارجع من الطريق اللي جيت منه لوما توصل عند اشاره المرور. بعدين، لف يسار.	إنها بجور ذلك المبنى المرتفع . لذلك ارجع في نفس الطريق الذي أتيت منه حتى إشارة المرور . ثم اتجه يساراً .
لازم الحق طياره ل لوس انجلس بكره الصبح بدري.	علي أن ألحق طائرة متجهة للوس أنجليس باكر صباح غد .
"ذاحين شا اقدر انصحك وانا واثق ب ""جولة مدينه سان فرانسيسكو"" هذه. هذا يدي لك الخطوط العريضة حق سان فرانسيسكو."	إذاً يمكنني بكل ثقة أن أزكي برج مدينة سان فرانسيسكو . فهذا يعطيك فكره عن سان فرانسيسكو .
اشتي احصل ضمان.	أريد الحصول على تأمين .
تشتي تشتري فستان.	تريد أن تشتري ثوبا .
بكم التاكسي للفندق؟	كم أجرة التاكسي حتى هذا الفندق ؟
أين هو الحمام؟	أين الحمام ؟
هل بيكلف اي شي عسب ادخل لهذه العماره؟	هل يكلفني دخول هذا المبنى أي أموال ؟
اعملها بطريقتك.	قم بها بطريقتك .
الطاقه حانبه.	النافذة محشورة .
نص وقيه من شانيل رقم خمسه، لو سمحت.	نصف أوقية من شانيل رقم خمسة من فضلك .
ما رايك ب قهوة؟	ما رأيك في بعض القهوة ؟
احتاج تذكره؟	هل أنا بحاجة إلى تذكرة ؟
حوالي كم تكلفه الخدمه؟	ما هي تكلفة الخدمة تقريبا ؟
كم هو بعيد من هانا؟	كم المدة التي يستغرقها من هنا ؟
كريمه وسكر؟	كريمة وسكر ؟
به سوبر اكسبريس على تسع ونص؟	هل هناك قطار فائق السرعة في التاسعة والنصف ؟
خليني افحص زيت البريك والمكينه. شكل مكينتك قديه خاربه.	دعني افحص سائل الفرامل والمحرك . يبدو أن محرك سيارتك قد أوشك علي التوقف .
ما كانتش غلطتي.	لم يكن خطئي .
مابش كهرباء.	لا كهرباء .
عيدفع كل واحد على مشروبه؟	هل سيحاسب كل واحد منا على مشروباته منفردا ؟
ب اي بقعه من ثلاثين الى خمسين دولار بالليله.	في أي مكان من ثلاثين حتى خمسين دولارا لليلة .
لو سمحت صلح ذيه.	من فضلك ، اصلح هذه .
في ليله راس السنه. وفي مناسبات خاصه مثل حفلات الزفاف، حفلات التكريم و العزاء.	في أيام السنة الجديدة . وفي مناسبات خاصة مثل حفلات الزواج ومراسم منح الجوائز أو في العزاء .
ليش ما تدي لها هديه؟	لماذا لا تعطيها هدية ؟
هي ضربتني بالجمب.	لقد انتقدتني ضمنا .
شا اقدر امر على ثنتين.	يمكن أن أحضر في الساعة الثانية .
هل هذلا الشنط من رحله جيه إيه إل صفر واحد؟	هل هذه هي حقائب الرحلة جال صفر واحد ؟
هذه رحلتي الاولى لباريس.	هذه هي رحلتي الأولى إلى باريس .
تقدر تخمن التكلفه قبل ما تبدا تشتغل عليه؟	هل لك أن تقدر التكلفة قبل أن تبدأ العمل فيها ؟
اشتي العب تنس.	أود لعب التنس .
به عصير اناناس، برتقال و طماط.	يوجد عصير أناناس وبرتقال وطماطم .
الجهه اليسار ل هذا الدور، قريب من الدرج الكهربائي.	الجانب الأيسر من هذه الدور بجوار المصعد .
تمانع لو تبسر فلم ثاني؟	ما رأيك في مشاهدة فيلم آخر ؟
شا اقدر ادي لك اجابه احسن لهذا بعد عدد من العروضات.	ربما أعطيك إجابة أفضل من تلك بعد عرضين .
ايش من عروض موسيقيه بتنعرض الان؟	ما هي المسرحيات الموسيقية المعروضة حاليا ؟
معك مرايه؟	هل لديك مرآة ؟
شا اشل هذا، لو سمحت.	سوف آخذ هذه ، من فضلك .
ايش من طباخه رائعه هي زوجتك.	ما أروع زوجتك من طاهية .
ممكن تحجز لي تاكسي ل ست الصبح بكره، لو سمحت؟	هلا حجزت لي تاكسي الساعة السادسة صباح غد , من فضلك ؟
ايش تشتي ب دخلتك؟	ماذا تفضل مع طبقك الرئيسي .
هذا البقعه ملان ناس، صح؟	هذا المكان مكتظ بالناسب ، أليس كذلك ؟
عفوا. عيوقعين جاهزات في حوالي خمس دقايق.	عفواً . ستكون جاهزة في غضون خمس دقائق .
وقعت لي عصبه في رقبتي وانا راقد.	عانيت من ألم في الرقبة أثناء نومي ؟
في اي وقت المفروض اكون بالمحطه؟	متى يتعين علي أن أكون في المحطة ؟
هو جمب غرفة الامانات.	بجوار حجرة الإيداع .
استمتعت ب جلستي. شكرا لك.	لقد تمتعت بإقامتي . شكراً لك .
الساحل تحت تماما. ما احلى المنظر.	الشاطئ أسفل يمينا . ياله من منظر رائع .
سبعه، لو سمحت.	سبعاً ، من فضلك .
اشتي ارسل هذا للمغسله. ايحين عيوقع جاهز؟	أريد أن أرسل هذا إلى المغسلة . متى ستكون جاهزة ؟
معي بنطلون مخطط.	لقد خلعت البنطلون .
ايوة. به شنطه حق واحد ثاني وصلت لغرفتي الان. ممكن تبسر كيف، لو سمحت؟	نعم . تم نقل أمتعة شخص آخر إلى غرفتي تواً . من فضلك ، هل من الممكن أن تقوم بفحصها ؟
رقدت سوا؟	هل استرحت في نومك ؟
ممكن تضغط زر التصوير؟	هلا ضغطت على زر مصراع النافذة ؟
هو في نهايه الممر.	في نهاية الممر .
عنسير بباص؟	هل سنذهب بالحافلة ؟
انا لازم احول ل اي دبليو واحد صفر صفر. هلو هو ممكن؟	يجب أن أنتقل إلى عربة مكيفة واحد صفر صفر . هل هذا ممكن ؟
مابش مشكله. اذا جيت ب خمسه سبتمبر، عتقدر تستمتع ب عرض الفلم العلمي لانه معانا يوم مفتوح خاص في اول جمعه من كل شهر.	لا توجد مشكلة . إذا حضرت في الخامس من سبتمبر ، فسيكون بإمكانك الاستمتاع بعرض فيلم علمي لأن عندنا يوماً خاصاً مفتوحاً أول يوم جمعة من كل شهر .
معك اي جوله ثانيه؟	هل لديكم أية جولة سياحية أخرى ؟
تمام، تخفيض خمسه بالميه. هل هذا سابر؟	حسنا . خصم خمسة في المائة . هل يوافقك لك ؟
انا ساير باريس.	إنني ذاهب إلى باريس .
مشو اخر موديل، اولا؟	إنها ليست أحدث طراز ، أليس كذلك ؟
قدوة محدد ل ثمان و ثلاثين في الليل حسب التوقيت المحلي.	موعده المقرر هو الثامنة والنصف مساءْ بالتوقيت المحلي .
شل هذا المبنى معانا، لو سمحت.	أظهر هذا المبنى معنا , من فضلك .
تمام. شا اشل طايه متوسطه و كره رز.	حسناً . أريد سلطانية من الحجم المتوسط ، وكرات الأرز .
كيف هذا اللوك؟	كيف يبدو هذا ؟
اشتي ابسر هذاك في الطاقه، لو سمحت.	أريد أن أرى ذاك الذي في نافذة العرض ، من فضلك .
مستحيل. احنا في عطله. انا ارفض الجلسه بالفندق ونبسر البيسبول في التلفزيون. اشتي اسير ابسر اللعب.	مستحيل . نحن في إجازة . إنني أرفض الجلوس في غرفة بالفندق ومشاهدة البيسبول في التلفاز . أريد الذهاب لمشاهدة مسرحية .
اقدر اعسه؟	هل بإمكاني اللمس ؟
انا اسمي تارو تانكا. معي حجز.	"اسمي "" تارو تاناكا "" لدي حجز مسبق ."
اشتي جمبر ابو اكمام طوال.	أريد رداءا ذات أكمام طويلة .
سرقت من شنطتي.	لقد سُرقت حقيبتي .
شكل ان طريقنا بيتقاطع خيرات مرات، صح؟	لقد تقابلنا بالصدفة لعدة مرات ، أليس كذلك ؟
ممكن ابسر المنيو مرة ثانية؟	هل يمكنني أن ألقي نظرةً أخرى على قائمة الطعام ؟
عادهن شكلهن خضر شوية.	لا تزال تبدو عليهم علامات المرض وشحوبة الوجه .
كم؟	كم عددها ؟
ماشي، عادو. به خيرات للإختيار منهم.	لا ، ليس بعد ، هناك الكثير نختار فيه .
اسف مابش ملعب غولف هانا.	أخشى أن لا يكون هنا أية دورة لتعليم الجولف .
ممكن توريني ثاني خاتم من اليسار؟	هل لك أن تريني الخاتم الثاني من جهة اليسار ؟
ممكن تقوله يتصلي؟	ألا تسأله أن يتصل بي ؟
حاولت اتصل اتصال دولي. قد وصلت؟	لقد حاولت إجراء مكالمة دولية ، هل نجح ذلك معك من قبل ؟
ايوه. لأنك عتبسر العلم قدام مكتب البريد.	نعم ، هي ، لأنك تستطيع أن ترى العلم أمام مكتب البريد .
اشتي افعل اتصال بإستخدام بطاقة الإئتمان حقي.	أود إجراء مكالمة هاتفية باستخدام بطاقة ائتمان .
اشتي حقي يسير.	أريد ما يخصني لكي أرحل .
لما توصل، عندفع عاسب نوصلها لا عنوان بيتك.	لدي وصولها ، سوف ندفع ثمن شحنها إلى عنوان منزلك .
ها، تمام. فهمت. شاجي انا لا بقعتك.	أوه ! موافق ، لقد فهمت ، سوف آتي إلى مكانك .
لأ، هذا يكفي.	لا ، هذا يكفي .
ممكن اخذ بطانية و وسادة؟	هل لي أن آخذ بطانية ووسادة ؟
ممكن تجي هانا في أقرب وقت، لوسمحت؟	هل يمكنك أن تحضر هنا قريباً بقدر المستطاع ، من فضلك ؟
قلص قهوة، لوسمحت.	قدحاً من القهوة , من فضلك .
ممكن تخصر الخصر ثلاثة سنتي متر؟	هل لك بأن تضيق منطقة الوسط سنتيمترات ؟
انا في نفس العمر.	إنني في نفس السن .
ممكن تدي لي قهوة؟	ألا تحضر لي بعض القهوة ؟
تعرف لو به اي فنادق رخيصة؟	هل تعرف ما إذا كان هناك أي فنادق رخيصة الأسعار ؟
صباح الخير. رقدت سوا؟	صباح الخير . هل استرحت في نومك ؟
ايش انت ناوي تفعل لما تتم المدرسة؟	ماذا تنوي أن تفعل عقب الانتهاء من المدرسة . ؟
سرق الشنطة من كتفي في الشارع.	سرقت حقيبتي في الشارع .
معك اي خدمات جمب الصبوح اليوم الصبح؟	هل كان لديك أية خدمات أخرى إلى جانب طعام الإفطار هذا الصباح ؟
اشتي قلص قهوة بيضاء، لوسمحت.	من فضلك ، أريد فنجاناً من القهوة البيضاء .
اشتي استأجر سيارة من هذا النوع ليومين.	أبغي تأجير سيارة من هذا الطراز لمدة يومين .
شا آخذ لقطة لجاك دانيلز.	سآخذ صورة لجاك دانيلز .
اشتي كيس تنفاش، لوسمحت.	أريد كيساً من الفشار ، من فضلك .
انا نكعت عصا التزلج.	سقط مني واحدا من عصى التزلج .
احنا ما نديش اي هدايا لمكتب الاستقبال. بالمقابل، الضيوف يدو كاش.	نحن لا نجلب أية هدايا إلى الحفل ، وبدلا من ذلك يحضر الضيوف أموالاً نقدية .
اشتي ارسلهن عبر البريد البري او البحري.	أود أن أرسله عن طريق البريد .
الحساب، لوسمحت.	الفاتورة من فضلك ؟
ممكن تاخذ رسالة، لوسمحت؟	من فضلك هل يمكنك أن تتلقى رسالة ؟
ممكن أصور؟	هل يمكنني أن التقط بعض الصور ؟
من ميه.	من مائة .
ممكن اشل طبق ساع هذا؟	هل بإمكاني الحصول على طبق آخر مثل هذا ؟
صاحب الصيانه عيوقع هانا قريب.	عامل الصيانة سيصعد في الحال .
به اي شواغر في جوله يوم الخميس؟	هل هناك أماكن شاغرة بالنسبة لرحلة الخميس ؟
عفوا. بس ممكن أعدي؟	عفواً . هلا سمحت لي بالمرور ؟
معك أي نباتات أو فواكة؟	هل لديك أية نباتات أو فواكه ؟
لو سمحت قل لي كيف اعبي بطاقه النزول؟	من فضلك أخبرني كيف أملأ بطاقة النزول إلى البر ؟
اعتقد ان سيارتي تستحق حوالي خمسة ألف دولار.	أعتقد أن سيارتي تستحق حوالي خمسة آلاف دولارا .
هل هذا الأكل قليل السعرات الحرارية؟	هل هذا الطعام منخفض السعرات الحرارية ؟
ايش من باص لازم اشل عاسب اسير المحطة؟	أية حافلة يجب أن آخذ إلى المحطة ؟
شاكون ممنونه لك لو تشلني للشاطئ.	أكون ممتنا جدا لو أخذتني إلى الشاطئ .
اعتذر. معك الرقم الغلط. هذه تانكيوشا برس.	آسف . لقد اتصلت بالرقم الخطأ . هذه وكالة تانكيوشا الصحفية .
عنخرج.	إننا سندفع الحساب ونغادر .
هذا الموديل موجود بمقاس ثمانية وعشرين، واحد وثلاثين وخمسة وثلاثين سنتيمتر.	هذا الموديل متوفر بمقاسات ثمانية وعشرين , وواحد وثلاثين وخمسة وثلاثين سنتيمترا .
اوه، هذا شكله خيرات.	أوه , يبدو كأنه قرعة .
ممكن استخدم تلفونك؟	هل يمكن أن أستعمل هاتفك ؟
محفظتي، جوازي واشياء شخصية ثانية.	محفظتي , جواز السفر ومتعلقات شخصية أخرى .
ايحين تغلق؟	متى تغلقون ؟
هذا بالضبط اللي كنت شاقوله.	هذا بالضبط ما كنت سأقوله .
ايوه، اعتقد.	نعم , أعتقد ذلك .
هذا البيت كبير. كم به غرف؟	منزلك كبير . كم عدد الغرف ؟
استمتعنا بالعشاء.	استمتعنا بالعشاء .
ايوه، لوسمحت. اتمنى انهم مايصابوش بدوار البحر.	أوو ، نعم ، من فضلك . أنا أتمنى أن لا يصابوا بدوار البحر .
ماهو الوقت التقريبي حقنا للوصول؟	ما هو موعد وصولنا المقدر ؟
هو مشغول ذلحين.	هو مشغول الآن .
عادي الأجانب يستخدموا الكتب في هذه المكتبة؟	هل الأجانب يمكنهم الحصول على الكتب في المكتبة ؟
هل ممكن اجلس في غرفتي لا الساعة ثنتين بعد الظهر؟	هل من الممكن أن أمكث في غرفتي حتى الثانية مساءً ؟
ههههه. صباح الخير. عادي.	ها-ها . صباح الخير حان دورك . إنه على ما يرام .
اشتي فيلم من رقم هذا ال ايه اس ايه لهذه الكيمره، لو سمحت.	أود بعضاً من فيلم رقم ايه إس ايه لهذه الكاميرا ، من فضلك .
ايش من متزلج رهيب.	يا له من راكب ماهر للأمواج .
أسف الأكمام قصار قوي.	أخشى أن تكون الأكمام قصيرة جدا .
ممكن توريني كيف أعبي بترول؟	هل يمكنك أن تريني كيف أضع الغاز ؟
قدو هذا كله؟	هل هذا كل شيء ؟
غرفتي باردة قوي.	غرفتي أبرد من اللازم .
شارجع لك لما نفضى شوية.	سأعود إليك عندما تكون أقل انشغالاً .
قدني احسن.	أشعر بتحسن .
لو سمحت وريني وين انا في هذه الخريطة.	من فضلك أرني أين أنا على هذه الخريطة .
مية في المية قطن.	مائة بالمائة قطن .
اشتي اغير لا غرفة مطلة على المحيط. هل به اي رسوم إضافية؟	أود أن أغير لغرفة تطل على المحيط . هل توجد أي رسوم إضافية ؟
كم ايجار القارب لنص يوم؟	كم ثمن إيجار نصف يوم للوحة ؟
طعيم قوي.	إنها لذيذة جداً .
كيف تخلي السواق يعرف لما تشتي تنزل؟	كيف عرفت السائق متى تريد أن تنزل ؟
اربعة وعشرين دولار. تشتي أكثر؟	أربعة وعشرين دولاراً . هل تريد المزيد ؟
فعلت الحجز في طوكيو من قبل شهر .	عملت الحجز في طوكيو منذ شهر .
اقدر انزل من هانا لمركز روكفيلر؟	هل أنزل هنا لمركز روكفيلر ؟
لوسمحت صلح لي مقاس جزمتي.	من فضلك قس حجم حذائي .
يجنن.	إنها رائعة .
لوسمحت نظف هذا الكوت.	من فضلك نظف هذا المعطف .
اشتي استأجر قارب.	أود أن أؤجر قارب بمحرك .
وينو قسم النسوان؟	أين قسم السيدات ؟
ماتتضمنش قهوة؟	القهوة غير محسوبة .
ايش كان مجاله من أول؟	في أي مجال كان من قبل ؟
جرحي بيوجعني.	جرحي يؤلمني .
وين المحطة؟	أين المحطة ؟
ثلاثة ايام.	ثلاثة أيام .
مشتيش واحدة ضخمة.	لا أريد واحدة ضخمة .
عيكون به شوية تأخير.	سيكون هناك تأخير بسيط .
هو هذا الفرق بين هولا الفنادق؟	ما هي الفوارق بين هذه الفنادق ؟
كان يجنن. شكرا.	كان عظيماً . شكراً .
مابش حاجة أطول شوية؟	هل لديك أي شيء لفترة أطول قليلاً ؟
به اي كازنوهات حاليه؟	هل توجد أية كازينوهات جيدة ؟
ذا هي الزلط حق الاقلام. فاتوره بميه دولار.	هذه هي فلوس أقلام الحبر . فاتورة بمائة دولار .
اين قسم السيدات؟	أين قسم السيدات ؟
وينهو قسم النسوان؟	أين يمكن أن أركب القارب ؟
صاحبي موجوع.	صديقي مصاب .
شكلك بخير.	تبدو بصحة جيدة .
ممكن لوسمحت ترتب لي شنبي؟	هل يمكنك أن تشذب شاربي ؟
ممكن احجز خمسة كراسي سوا في نفس البقعة؟	هل يمكن أن أحجز خمسة مقاعد في الصف نفسه .
ايش من سياره تقطع اكثر اميال؟	أي سيارة ذات أداء أفضل ؟
ماعتاخذش تخفيض حتى لو حاولت قوي.	لن تأخذ خصماً مهما حاولت .
ممكن تفتح لي هذه الشنطة، لوسمحت؟ ايش معاك هانا؟	هلا فتحت هذه الحقيبة ، من فضلك ؟ ماذا يوجد هنا .
اشتي افعل مكالمة بعيدة لا فندق هيلتون في بوسطن.	أريد أن أعمل مكالمة مسافة طويلة إلى فندق هيلتون في بوسطن .
اوبه، السقف واطي.	كن حذراً ، السقف منخفض .
زرت الشلالات العظيمة لأول مرة؟	لا أستطيع رؤية الشاشة جيداً من هنا ، هل يمكنني تبديل المقاعد لبعض الوقت ؟
انا زرت البحيره العظيمة لاول مره.	لقد قمت بزيارة البحيرات الكبرى لأول مرة .
به شي غلط ب الة البيع هذه.	ثمة شئ خطأ في آلة التهوية هذه .
احتاج دكتور.	أحتاج إلى طيب .
ايحين؟	كم الوقت ؟
بتبسر بناية بيضاء، صح؟ هي قدام هذه البناية.	يمكنك رؤية مبنى ابيض اللون ، أليس كذلك ؟ إنه أمام ذلك المبنى .
بين احس انه بيتبسروني. هل هو نادر انهم يبسرو واحد ياباني؟	اشعر كأن هناك تحديق في . هل من النادر رؤية شخص ياباني ؟
ايش من طريق هو المدخل لمكتب البريد الرئيسي؟	أي طريق يؤدي إلى مكتب البريد المركزي ؟
اين مستودع باص جريهاوند في هذه المدينه؟	أين محطة أتوبيس جرايهاوند في هذه البلدة ؟
اشتي تقييم الكتاب.	أريد سعر الكتاب .
منين اقدر اشتري تذكرة المترو؟	أين يمكنني شراء تذكرة للمترو ؟
شااحصل على مقاعد درجة رجال الأعمال، صح؟	سآخذ مقاعد درجة رجال أعمال ، أليس كذلك ؟
كم رسوم التكسي من هذا الفندق للمحطة؟	كم أجرة التاكسي من هذا الفندق إلى المحطة ؟
ممكن اشل هذه وهذه، لوسمحت؟	هل لي بهذه وهذه ، من فضلك ؟
قالوا اليابان دولة غنية قوي.	يقولون أن اليابان دولة غنية جداً .
به اي غرف فاضيه ب الكارافان؟	هل هناك أي غرف خالية في عربة النوم ؟
هذه هدية لصاحب.	هذه هديه لصديق .
الثلج بيخلي الطريق مطاحسه.	الثلج يجعل الطريق زلق .
مالقيتش حقي الكاميرا.	لا أستطيع أن أجد كاميرتي .
معك شي توضحه؟	هل لديك أي شئ لإعلانه ؟
انا من طوكيو.	أنا من طوكيو .
اشتي كريم غسول ريفلون .	أريد بعض الغسول لإزالة كريم ريفلون .
شا اخذ هوت تشوكلت.	سآخذ شيكولاتة ساخنة .
بكم لافندق سي؟	كم تكلفة الذهاب إلى فندق سي ؟
اشتي احجز طاولة لشخصين الساعة سبع، لوسمحت.	أود حجز مائدة لفردين في الساعة السابعة , من فضلك .
الساعه ثلاث وربع.	إنها الثالثة والربع .
شا اخطط لارسال فواتير احتياجاتي اليوميه، ف لو سمحت قل لي عنوان واسم الشخص المسؤول.	سأخطط لإرسال فواتير حاجياتي اليومية ، لذا من فضلك أخبرني العنوان و اسم الشخص المسئول من فضلك .
معك هولا بنفس التصميم بس بكعب اعلى؟	هل لديك نفس هذا التصميم بكعب أعلى ؟
متأكد ان معي حجز.	أنا متأكد أن لدى حجز .
شارسله لك، لذلك لوسمحت راعي هانا.	سأرسلها لك ، لذا من فضلك انتظر هنا .
استمتعت بالوجبه قوي.	لقد استمتعت بالوجبة كثيراً جداً .
ماشي، لو سمحت اجلس وراعي. شا ارجع لك.	لا ، من فضلك اجلس وانتظر . سأعود بعد قليل .
ممكن ترسم لي الخريطه، لو سمحت؟	هل لك أن ترسم لي خريطة , من فضلك ؟
انا مودف ب شاطئ وايمانالو. لو سمحت جي ذاحين.	لقد سرقت في شاطئ وايمانالو . من فضلك تعالى فوراً .
اشتي هذا مقرطس.	أريد هذا معبئاً .
اشتي اقدم طلب اعاده اصدار.	أريد أن أقدم طلباً للحصول على إصدار جديد .
الحكومه دعمت تقدم المصانع.	لقد دعمت الحكومة تنمية الصناعات .
هو فوق الخمسين سنه، اتوقع.	أعتقد أن عمره أكثر من خمسين سنة .
معك اي خرايط بسيطه للمدينه؟	هل لديك أيّ خرائط بسيطة للمدينة ؟
ايحين عيوصل القطار ل سان دييغو، لو سمحت؟	متى سيصل القطار إلى سان دييجو ، من فضلك ؟
اشتي اعمل نظره لحقك الصندوق.	آوه إلقاء نظرة على صندوقك .
اشتي شويه شامبوه.	أريد بعض الشامبو .
انا جالس في فندق هيلتون.	أنا أقيم في فندق هيلتون .
بين احس بتعب وغاثي.	أشعر بحالة سيئة وغثيان .
لكن معي موعد عسب ابسرها الساعه ثنتين.	لكنّي لدى موعد لرؤيتها في السّاعة الثّانية .
تيه السياره بتمشي ل ايدنبره؟	هل تذهب هذه السيارة إلى إدنبرة ؟
ايوة، لو سمحت عبي الاستمارة.	نعم ، رجاءً املأ هذه الاستمارة .
كم بتفعل كلفه للوزن الزايد؟	ما هو مقدار الرسوم للوزن الزائد ؟
ف اي وقت اقدر اخرج؟	في أي وقت يمكنني مغادرة الفندق ؟
فهمت.	فهمت الأمر .
شا اتصل ب واحد.	سوف أطلب شخصاً ما .
السياره جت لاعرضي من جهه التقاطع.	السيارة جاءت لي من الجانب عند التقاطع .
اين هي الضاحيه؟	أين الضاحية ؟
به جوله بباص المدينه؟	هل هناك جولة بالحافلة تجوب المدينة ؟
ب ايش وقت نبدا؟	في أي وقت نبدأ ؟
تمام، سيدي. بالحجم الوسط نقدر نعرض عليك ميركيوري سايبل. هل هذا سابر؟	"حسنا ، يا سيدي . في الحجم المتوسط نعرض عليك فرو السمور من نوع "" ميركوري "" ، فهل ذلك يوافقك ؟"
لكن ضروري انك توعدني انك تضرب الكره، مش انا. تمام؟	ولكن عليك أن تعدني بركل الكرة ، وليس أنا . موافق ؟
كم هو ابعد؟	إلى أي مسافة يبعد أكثر ؟
ممكن اتسلف شويه كتان؟	هل لي في استعارة بعض البياضات ؟
من ايش من جلد الشنطه هذه مصنوعه؟	من أي نوع من الجلد الصناعي صُنعت حقيبة السفر هذه ؟
ما اعتقد ان هذه السكينه نظيفه. ممكن تدي لي واحده ثانيه؟	لا أعتقد أن هذه السكينة نظيفة . أيمكنك أن تُحضر لي واحدة أخرى ؟
انا اشتريت هذه قبل شويه، لكن عتقدر تغير هذا بدل ذيك؟	لقد اشتريت هذه من لحظة ، ولكن هلاً بدلت هذه بتلك ؟
بصراحه، ما اتفقش مع هذا.	بصراحة ، لا أتفق مع ذلك .
ذيه الطريق الصح للمحطه المركزية؟	هل هذا هو الطريق الصحيح إلى المحطة المركزية ؟
قارب مع مرشد، لو سمحت.	قارب مع مرشد ، من فضلك .
هذه المظلة عتنفع عصية.	هذه المظلة يمكن استخدامها كعصا للسير .
لو سمحت رويني جوازك.	من فضلك أرني جواز سفرك .
به هانا اي بقعه يقبلو الغسيل ايام الاحد؟	هل يوجد مكان يقبل تنظيف الملابس في أيام الآحاد ؟
اثنين برجر بالجبنه، لو سمحت.	سندويتشان برجر بالجبن ، من فضلك .
ايش من باص يسير ل ميامي؟	أية حافلة تذهب إلى ميامي ؟
عتقدر تبسر واحد في قاعه كارنيجي.	"بمقدورك أن ترى واحداً عند "" كارينجي هول "" ."
انا مش معتمد.	لستُ معتمداً قانونياً .
ايش خاصية البيت؟	ما هو الصنف المميز للمحل ؟
اشتي احجز عند دكتور.	أودّ حجز موعد مع طبيب .
ما عندكش مانع اجي لعندك؟	أنت لا تمانع في حضوري إلى منزلك ؟
شكل انه به مجال للتحسين.	يبدو أن ثمة مجالات للتحسينات .
اين هو قطار الانفاق؟	أين مترو الأنفاق ؟
به معك منه بمقاس اصغر؟	هل عندكم منه بحجم أصغر ؟
من اين اقدر احصل اسبرين؟	أين يمكنني الحصول على أسبرين ؟
هذا هو قاع الصخره؟	ذلك الحد الأدنى للسعر .
لو سمحت اديلي تذكره دخول لمده اسبوع.	من فضلك اعطني تصريحاً سارياً لمدة أسبوع .
هذا هو زميلي.	هذا زميلي .
ايش به من انواع البترول؟ بريميم، عادي، ونقي؟	أي نوع من البنزين هناك ؟ السوبر ، أم العادي ، أما الخالي من الرصاص ؟
"هو قال ""هيا نحتفل"" وشلني للبار. هو قال انه كان عيسير يتصل و خطي وماعد رجعش وانا حنبت بفاتوره غاليه."	دعونا نحتفل  ، هكذا قال وآخذني إلى بار . وقال إنه سيُجري مكالمة هاتفية وغادر ولم يعد أبداً وتحملت أنا وحدي عبء فاتورة ضخمة .
بكم هو لكل جالون؟	كم تكلّف هي لكل جالون ؟
الحجز على سبع، تحت اسم مانوو.	الحجوزات في السابعة ، تحت اسم مانو .
ما عتشل قلص شاهي؟	ألا ترغب في فنجان شاي ؟
به دكتور الفندق او اللذي بالعقد؟	هل هناك طبيب للفندق أو واحد على صلة بالفندق .
هو دايما يتسوق في شارع بوند.	"إنه يقوم دائماً بالتسوق في شارع "" بوند "" ."
ورقه انجليزيه، لو سمحت.	جريدة باللغة الإنجليزية ، لطفاً .
به صوفيات ثانيات؟	أي منتجات صوفية أخرى ؟
بكم هو لكل ورقه؟	كم تكلف الملاءة الواحدة ؟
طيب، اضغظ تسعه و صفر واحد واحد، وبعدين رمز البلده و رقم التلفون.	حسنا ، اضغط تسعة وصفر واحد واحد ، ثم الكود الخاص بالبلد ورقم الهاتف .
ممكن تدي لي كوك دايت؟	هل يمكن أن أحصل على كوكاكولا دايت ؟
كانت سواقه حاليه. شكرا لك.	استمتعنا بجولة لطيفة بالسيارة . شكراً لك .
مجموع سكان اليابان هو حوالي ميه وثلاثين مليون.	إجمالي سكان اليابان حوالي مائة وثلاثين مليوناً .
اشتي استاجر مظله.	أود استئجار شمسية .
ايوة، و اشتي تعكس الرسوم.	أجل ، وأودّ محاسبة المطلوب هاتفياً على قيمة المكالمة .
محفظه داخلها ميه دولار و ثنتين بطايق ائتمان.	محفظة بها مائة دولار وبطاقتان ائتمانيتان .
قوي مابش شبه.	غير محتمل بدرجة كبيرة .
بطني توجعني بعد الوجبات.	معدتي تؤلمني بعد الوجبات .
واو، هذا مكان حالي.	عظيم ، ذلك مكان لطيف .
قد قررت؟	هل قرّرتَ ؟
ما تقدر تغير وظيفتك بسهوله.	ليس بمقدورك تغيير وظيفتك بسهولة .
ما هي المحطه اللي عتجي؟	ما هي المحطة التالية ؟
مشتيش اي شي ثقيل.	لا أريد أي شيء يكون كبير الحجم .
الرسوم، لو سمحت. انت بتاخذ فيزا؟	التكلفة ، من فضلك . هل تقبلون بطاقة فيزا ؟
اليوم شا اسير ابسر كيف مدينه الصين.	اليوم سأذهب لأرى كيف يبدو الحيّ الصين .
اثنين صفر اثنين تسعه ثلاثه تسعه سته سبعه صفر صفر.	اثنان صفر اثنان تسعة ثلاثة تسعة ستة سبعة صفر صفر .
اشتي سنتي تقتلع.	أرغب في خلع أسناني .
اشتي شنطه مكياج.	أرغب في حقيبة مستحضرات تجميل .
"اين شا اقدر ابسر ""الفانتوم اوبرا""؟"	"أين يمكنني مشاهدة عَرْض "" شبح الأوبرا "" ؟"
اشتي اشتري هدايا لاصحابي. تقدر تنصحني ببعضهن؟	أريد شراء تذكارات لأصدقائي . أيمكن أن تُوصي ببعض منها ؟
ابطئ زيادة، لو سمحت.	بطريقة أبطأ ، من فضلك .
مقلي من الجهتين، لو سمحت.	مقلية على الجانبين ، من فضلك .
بيكون جاهز بعد بكره في المساء.	سيكون جاهزا بعد غد في المساء .
ذيه مصنوع من القطن؟	هل هذا مصنوع من القطن ؟
ايش شاقدر ابسر في هذك الجوله؟	ما الذي يمكن أن أراه في هذه الجولة ؟
بكم هو لليوم الواحد؟	ما تكلفة هذا في اليوم ؟
اشتي سي دي.	أريد اسطوانة مدمجة .
به رحلات الخطوط الجوية اليابانية و أول نيبون اللي يمشين على عشر وخمسه-وخمسين. لكن، لسوء الحظ الرحلتين ملان.	توجد رحلات جوية على شركات جال وانا التي تقلع في الساعة العاشرة وخمسة وخمسين دقيقة . ولكن , للأسف كلتا الرحلتين محجوزتان .
جاء عليا سوى.	تناسبني تماما .
هي ما تفهمش انجليزي بالخالص.	إنها لا تفهم الإنجليزية مطلقا .
عتقدر تعتني بها من تسع الصبح ل حوالي ثلاث؟	هل يمكن أن تعتني بها من الساعة التاسعة صباحا حتى الثالثة ؟
بكم البريد الجوي لليابان؟	ما تكلفة البريد الجوي إلى اليابان ؟
انا مقفل عليا. تقدر تفتح الباب حقي، لو سمحت.	لقد أُغلق علي الباب . هل يمكن أن تفتح بابي , من فضلك ؟
ايش احسن جوله عسب نبسر احسن المناطق المعروفه؟	ما هي أفضل جولة حتى أرى أشهر الأماكن ؟
لا، يا سيدي. بعد الظهر محجوز كامل. بس بكره تمام.	لا يا سيدي . هذه الظهيرة محجوزة بالكامل . ومع ذلك يمكن أن تحجز غدا .
شا اسال الحارس عن الاجره بالضبط.	سأذهب كي أسأل البواب عن الأجرة المناسبة .
معانا حفله ليله الجمعة. ليش ما تجي تنضم لنا؟	عندنا حفلة مساء الجمعة . لماذا لا تنضم لنا ؟
طيب، غرفتش هي تسعه صفر ثمانيه، آنسه. هوذا مفتاحش.	حسنا , حجرتك يا آنسة هي رقم تسعة صفر ثمانية . هذا مفتاحك .
عفوا، فندم؟	معذرة , ضابط ؟
هذا القطار عيسير طوالي ل أدنبرة؟	هل هذا القطار يتجه مباشرة إلى إدنبره ؟
خرج حقي الأشياء الغاليات، لوسمحت.	أخرج متعلقاتي الثمينة , من فضلك .
كيف الزحمه في الجولات السياحيه؟	كيف يكون الزحام في مثل تلك الجولات ؟
أشتي أشتري شوية هدايا تذكارية. به محل مناسب قريب من هانا؟	أود أن أشتري بعض التذكارات . هل يوجد هنا محل مناسب ؟
لا ايحين عيجلس فاتح؟	إلى متى تظل مفتوحة ؟
هو خارج ذاحين.	إنه في الخارج الآن .
مايومي، ممكن تعبي هذه الورقه مع توقيعش؟	مايومي , هل تسمح أن تملأ هذه الورقة بتوقيعك ؟
هوذا واحد لك، سيدي.	إليك إحداها يا سيدي .
معك أفلام الصيف؟	هل لديكم أفلام للصيف ؟
ايحين القطار الثاني ل واشنطن دي سي؟	متى يأتي القطار التالي المتجه إلى واشنطن العاصمة ؟
شرجع لليابان الاثنين الثاني.	سأعود إلى اليابان الاثنين المقبل .
ممكن تديلي خريطة المترو؟	هل يمكنني الحصول على خريطة للمترو ؟
هل هي مسافه طويله؟	هل هو طريق طويل ؟
ممكن تبدل هذا بواحد جديد؟	هل يمكنك تبديل هذه بواحدة جديدة ؟
شخصين.	شخصان .
هدعش وخمسه وأربعين في الصبح.	الساعة الحادية عشر وخمس وأربعون دقيقة في الصباح .
كم مرات أغير القطارات عاسب أوصل لا هاناك؟	كم عدد المرات التي سأغير فيها القطارات للوصول إلى هناك ؟
رجع خمسه دولارات، لوسمحت.	الباقي خمسة دولارات ، من فضلك .
سدادة البانيو ما بتتغلقش سوى.	سدادة حوض الاستحمام لا تقفل بالكامل .
هو مجرد تذكار من تقديري.	إنها مجرد هدية تعبيرا عن تقديري .
ممكن تعبي هذه الاستماره؟	هلا ملأت هذا النموذج ؟
أيش من ماركات معك؟	ما هي الماركات التي توجد لديك ؟
ممكن تديلي طوابع بريديه ل ثلاث بطايق بريد جوي ل اليابان؟	هل يمكنني الحصول على طوابع بريدية لثلاث بطاقات بريدية جوية لليابان ؟
يتهجى ج-و-ر-و-ه.	تتهجي جي أوه آر أوه اتش .
تمدد هانا.	استلقي هنا .
خليها برقية طارئه، لوسمحت.	اجعلها برقية عاجلة ، من فضلك .
على حسب تقرير الجو، عينزل ثلج بكرة.	طبقاً لتقرير الطقس ، فإن غداً سيشهد سقوط جليد .
أشتي كرة.	أبغي كرة .
أكيد. عيكون لنا الشرف انحنا نفعله.	بكل تأكيد . سنكون سعداء لفعل هذا .
هيه، كتاب كوميدي ماليزي. اشتي اشتري واحد اشله للبيت ك قطعه محادثه.	هاي ، كتاب كوميدي ماليزي . سأشتري واحداً لآخذه إلى المنزل كقطعة محادثة .
"الطريق للنجاح هو "" جينمياكو، "" صح؟"	"الطريق إلى النجاح هو "" جينمياكو "" حقاً ؟"
شاكون هانا للساعه تسع. أتمنى أنك تمسك المجرم في أقرب وقت ممكن.	سأكون هنا حتى التاسعة . يحدوني الأمل أن تتمكن من القبض على المجرم في أقرب وقت ممكن .
انا متأكد ان المجرم قريب.	إنني على يقين أن المجرم قريب .
عشرة طوابع لو سمحت.	عشرة طوابع من فضلك .
فيني التهاب في الحلق.	أصبت بالتهاب في الحلق .
أحتاج شوية هدايا تذكاريه من نيويورك.	احتاج إلى بعض الهدايا التذكارية من نيويورك .
ساعتي وقفت.	توقفت ساعتي .
أوه، صدق هكذا؟ كيف عجبتك؟	أوه ، أهي كذلك ؟ كيف تفضلها ؟
احنا نفتح الساعه تسع في الصبح.	نحن نفتح في التاسعة صباحاً .
اشتي كتاب ملون.	أريد كتاب تلوين .
بينحس بدوخه.	أظن أنني مصاب بدوار الجو جواً .
ضروري أسير لا بنك ياباني؟	هل يجب أن أذهب على بنك ياباني ؟
لازم تصرف الزلط في البنك.	يجب أن تغير النقود من البنك .
عاد باقي وقت خيرات عاسب أسجل خروج؟	هل لدينا وقت كاف لإنهاء إجراءات المغادرة ؟
تعرف دكتور أسنان كويس؟	هل تعرف طبيب أسنان جيد ؟
مرجوج، مش مخلوط.	مهزوز ، وليس مضروب .
عدد كبير من الناس بيسيروا الشاطئ خلال الموسم.	يذهب عدد كبير من الناس إلى الشاطئ خلال الموسم .
انا وزني حوالي ميه وخمسين رطل.	وزني حوالي مائة وخمسين رطلاً .
اين هو مكتب الممتلكات المفقوده؟	أين مكتب الأشياء المفقودة .
به أي باص يسير لا هاناك طوالي؟	هل هناك حافلة تذهب مباشرة إلى هناك ؟
أنا أحتاج معاملة خاصة؟	هل أحتاج لعلاج خاص ؟
ذيك عيوقع كاش والا رسوم؟	هل سأدفع نقداً أم يضاف على الفاتورة ؟
كم عتاخذ وقت عاسب فيزتي تطلع؟	كم سيستغرق إصدار التأشيرة لي ؟
أين الحمامات؟	أين غرف الراحة ؟
المبلغ الأجمالي مئتين وثلاثه وأربعين جنيه، يا مدام.	إجمالي المبلغ المطلوب مائتان وثلاثة وأربعون جنيه ، يا سيدتي .
هذه هدية. ممكن تلفها بورق لف حالي؟	هذه هدية ، هل يمكن أن تلفها لي في ورق لف جميل ؟
يوو والمنظر. به طرق كبار.	ياله من منظر . إنها مسالك رائعة الجمال .
ايوه، معانا حجز لك.	نعم ، لدينا حجز لك .
عفوا، لكن اشتي اسير للفندق حقي في المدينة بالباص. من أين أقدر اشل باص؟	معذرة أريد الذهاب إلى فندقي في المدينة بالحافلة . أين يمكن أن أستقل حافلة ؟
هذه الغرفه اثنين صفر واحد. اشتي اطلب صبوح بكرة.	هذه الغرفة اثنان صفر واحد . أريد أن أطلب إفطار الغد .
بعدين هيا نطرح حشوة داخلز.	إذن دعنا نبطنها من الداخل .
كيف تشتي شعرك يتصلح اليوم؟	كيف تحب أن يصفف شعرك اليوم ؟
ممكن تقوله بكلمات ثانية؟	هل يمكن أن تقول لي ذلك بعبارة أخرى ؟
شا اعمل لك ب اي حاجه معك.	سوف استخدم ما يوجد عندكم .
نشتي طاوله قريب من المنصه.	نريد مائدة بالقرب من المسرح .
انا بخير. طيب، عتسير اي بقعه؟	أنا بحالة جيدة . حسنا , هل أنت ذاهب إلى مكان ما ؟
هو مرتفع الفين واربعميه متر.	إن ارتفاعه ألفان وأربعمائة متر .
هيا. لو سمحت اطرحه فوق الماسه هاناك.	ادخل . من فضلك ضعها على المائدة هناك .
لو سمحت ألغي رقم البطاقه حقي.	من فضلك الغي رقم بطاقتي .
انا اسف، كلهن قد ابتاعين، لكن عيجين بعد كم يوم.	آسف لقد نفدت ، لكن سوف تردنا بعد بضعة أيام .
مابش معي موعد، لكنو ضروري.	ليس لدي موعد ، لكن الأمر عاجل .
هذا معمول بردائه.	إنه رديء الصنع .
معاكم بروشور للاحداث؟	هل لديكم كتيب حول العروض ؟
من اين مدخل المترو؟	أين مدخل مترو الأنفاق ؟
ماتقدرش تجلس هانا في الأجازه؟	ألا تستطيع البقاء هنا خلال الإجازة ؟
يو، انا اسف أزعجتك.	أوه ، آسف لأني أزعجتك .
به حمام عام قريب من هانا؟	هل توجد غرفة استراحة عامة بالقرب من هنا ؟
ايشو الفندق؟	ما هو الإجمالي ؟
هذا قوي حالي. الان للاسئله، لو سمحت.	هذا جيد للغاية . والآن الأسئلة ، من فضلك .
معك فكة للعداد حق الموقف؟	هل لديك أية فكة لعداد الانتظار ؟
سعر حالي، صح؟	سعر رائع ، أليس كذلك ؟
لازم تاخذه تسعه-وتسعين مره باليوم، قبل الوجبة.	لابد أن تأخذها تسعة وتسعون مرة في اليوم ، قبل الوجبات .
اشتي تريبود.	أريد حامل ثلاثي .
كوت حالي. هل هو صناعة بريطانية؟	معطف رائع . هل هو صناعة بريطانية ؟
اشتي اسير مركز هارفرد. ممكن تقول لي لمن نوصل هاناك؟	أريد الذهاب إلى مركز هارفارد . هل يمكن أن تخبرني عندما نصل إلى هناك ؟
اثنين كبار واثنين جهال، لو سمحت.	بالغان وطفلان ، من فضلك .
ستار وارز كان اعظم نجاح في الف وتسعمية واربعة وثمانين.	"كان فيلم "" حرب الكواكب "" أكثر الأعمال شعبية عام ألف وتسعمائة وأربعة وثمانون ."
اين قسم غير المدخنين؟	أين قسم غير المدخنين ؟
ت مثل ماهو ب توم، ايوة هوذا هانا، يا تارو.	"حرف "" ت "" "" كما في توم ، نعم ها هي لدي هنا ، تارو ."
لايش هو هذا؟	ما فائدة هذا ؟
ايش من بطاقة ائتمان تقبل؟	أي بطاقات ائتمانية تقبلون ؟
طيب، قدوة وقت الغداء. تشتي تناقش الموضوع وقت الغداء؟	حسنا ، إنه وقت الغداء . هل تحب أن نناقشه على الغداء ؟
اهلا، اسمي أودا. انا معي حجز اليوم في الليل، بس شاتأخرشوية بتسجيل الدخول. لذلك لوسمحت خلي الحجز حقي.	ألو ، اسمي أودا . عندي حجز الليلة ، لكن سوف أتأخر في القدوم . لهذا من فضلك اتركوا لي الحجز .
هذلا الجزمات متينات؟	هل هذا الحذاء متين ؟
بالداخل.	لقد جاء لتوه .
انا اسف. احنا محجوزين بكره الليل.	آسف . الحجز كامل لمساء الغد .
على ما قال جورو، السيد يامادا معه اثنين جهال.	حسبما يقول جورو ، فاللسيد يامادا طفلان .
بنفسي اعمل لفه لبرج لندن.	أريد أن أعرج على برج لندن .
لو سمحت اربط حزام الامان.	من فضلكم . اربطوا الأحزمة .
هذا شويه غالي.	هذا مكلف نوعا ما .
طيب، ما اعرفش لحد الان، لكن اكيد شا احاول.	حسنا ، لا أعلم بعد لكنني سوف أحاول بالتأكيد .
لو سمحت استخدم غرفه القياس هاناك.	من فضلك استعمل غرفة القياس هناك .
تسعين دولار لتذكره ذهاب. كاش والا بطاقه؟	تسعون دولاراً لتذكرة الذهاب . نقداً أم بالبطاقة ؟
كيف الاباء اليابانيين يربو عيالهم؟ هل هم زريين مع جهالهم؟	كيف يربي الآباء اليابانيون أولادهم ؟ هل هم صارمون مع أطفالهم ؟
ممكن تقل لي ماهن ساعات العمل؟	هل يمكن أن تخبرني عن ساعات العمل ؟
بطني بين احسها ثقيله.	معدتي ثقيلة .
عنقدر نبدا نلعب لمن يتمو؟	هل يمكن أن نبدأ اللعب عندما ينتهون ؟
عبي هولا النقط في بطاقه التسجيل.	املأ البنود الآتية في بطاقة التسجيل .
اقدر اشل حاجاتي؟	هل يمكن أن أستعيد متعلقات ؟
عنديه الان. ما رقم غرفتك؟	سوف نحضرها الآن . ما هو رقم غرفتك ؟
تقدر تجهزة ل بكره خمس الليل؟	هل تستطيع تجهيزه بحلول الخامسة من مساء الغد ؟
يشل عشر دقايق مشي رجل.	إنها تستغرق عشر دقائق سيراً على الأقدام .
سكوتش و ماء، لو سمحت. معك اي وجبه خفيفه؟	ويسكي وماء ، من فضلك . هل لديكم وجبة خفيفة معه ؟
كيف اطفي هذا السراج؟	كيف يمكنني أن أطفأ الضوء ؟
هل هو مشغول اليوم قوي؟	هل هو مشغول جدا اليوم ؟
اشتي خيط.	أريد بعض الخيط .
اشتيك تقصرها لي انش واحد من هانا.	أود تقصيره ببوصة واحدة من هذه المنطقة .
مش انا بخير. لو سمحت اديلي لي علاج.	لا أشعر أنني على ما يرام . من فضلك اعطني بعض الدواء .
ممكن تدي لي جريده يابانيه، لو سمحت؟	هل يمكن أن أختر جريدة يابانية , من فضلك ؟
طيب. اقدر اجنب السياره ب اي بقعه؟ كم رسوم التجنيب؟	حسنا . هل يمكن أن أترك السيارة في أي مكان ؟ ما هي رسوم ركن السيارة ؟
به اكسبريس لبوسطن؟	هل يوجد أي قطار سريع إلى بوسطن ؟
انا قوي متحمس، ما اقدرش اقر.	أنا متأثر للغاية , لا أستطيع البقاء ساكنا .
اقدر انزل في فندق هيلتون؟	هل يمكن أن أنزل عند فندق هيلتون ؟
انا اشتيك تبعده.	أريدك تنزعه .
امشي يسار نهايه هذا الشارع و ادخل اول لفه يمين.	اتجه يساراً في هذا الشارع ثم انعطف عند أول منعطف يمين .
اشتي ادرى اذا هو ممكن اقدر ارسل هذلا الصحون لطوكيو.	أريد أن أعرف إذا كان يمكن شحن مجموعة الأطباق هذه إلى طوكيو .
اشتي طاقه جسديه.	أود بعضاً من القوة الجسدية .
به هانا اي اكل مشو مبسبس وحامي؟	ألا يوجد طعام متبل وليس حارا جدا ؟
هل هو قريب كفايه نخطى؟	هل هو قريب لنصل إليه سيراً .
ممكن تمرر لي الملح؟	هل يمكن أن تمرر لي الملح ؟
اشتي اسير لشارع وول؟	أريد الذهاب إلى وول ستريت . كيف أصل إلى هناك ؟
الرياضه الخيرات عتضرك.	الكثير جداً من التمارين يضر بك .
يتضمن الصبوح، الضرايب، وقيمه الخدمه، عتوقع حوالي خمسه واربعين دولار للشخص بالليله.	بما في ذلك الإفطار ، والضريبة ، ورسم الخدمة ، سيكون الحساب خمسة أربعون دولارا للشخص الواحد في الليلة .
عتقدر تصلح ذيه؟	هل تستطيع تصليح هذا ؟
امشي طوالي، لو سمحت.	سر مباشرة ، من فضلك .
الماء هانا امن للشرب؟	هل من المأمون شرب الماء الذي هنا ؟
اهاي، هيا. هو الا دولارين.	أهه ، هيا . دولارين فقط .
لو سمحت ممكن تبدل لي هذا الفستان بمقاس اكبر؟	هلا بدلت هذا الفستان بآخر من مقاس أوسع ؟
طيب، هيا نمشي. شا اقدر اساعدك بعملك بعد ما ناكل بيتزا.	حسنا ، هيا نذهب . أستطيع مساعدتك في واجبك المنزلي بعد أن نتناول بعض البيتزا .
ايوة، مستر تاناكا. به رسالتين لك.	نعم ، يا سيد تاناكا هناك رسالتان لك .
بكره يوم ثاني.	الغد يوم آخر .
ممكن اقدر اساعدك. تحتاج فيتامين سي؟	ربما أستطيع مساعدتك . هل تحتاج إلى فيتامين سي ؟
محفظتي استرقت من الجيب بالقطار.	إن محفظتي نشلت في القطار .
هو قوي بعيد. احسن تاخذ تاكسي.	إنه بعيد جداً . يحسن بك أن تأخذ سيارة أجرة .
ساكن بشقه ب ثمانيه الف ين بالشهر.	أعيش في شقة إيجارها ثمانون ألف ين في الشهر .
ممكن اتدخل؟	هل لي أن أقاطعكم ؟
عفوا. عندك مانع نغير المقاعد؟	معذرة . هل تمانع في أن تبادل المقاعد معي ؟
ايوة، بالتاكيد.	نعم ، بالطبع .
انزل منزل للركن ولف يسار عند اشاره المرور.	اذهب إلى الناحية وانعطف يساراً عند إشارة المرور .
اشتي اطرح حاجاتي الغاليه في خزنه الفندق.	أريد إيداع مقتنياتي الثمينة في خزينة الفندق .
ايوة، بس اتاكد ان تذكرتك تكون معك.	نعم ، ولكن تأكد أن تذكرتك معك .
شويه ناس بس اللي بينضمو للرحله الاختياريه.	لن ينضم للجولة الاختيارية إلا القليل من الناس .
لا تهم.	لا تهتم . على أي حال ، خذني من فضلك إلى مركز الحي الصيني . سأحاول أن أجده بنفسي .
ناس جدد بيتوظفو في ابريل.	تشغل أشخاصاً جدد في أبريل .
اتمنى ذلك.	أرجو ذلك .
اثنين سكوتش و ماء، لو سمحت.	اثنان ويسكي مع الماء , من فضلك .
من اللي بيلعب؟	من الذي يعزف ؟
لليسار، لو سمحت.	إلى اليسار ، من فضلك .
هذه السنه اللي بالقدام توجع.	هذه السن في المقدمة تؤلمني .
ما هي اخر لعبه بالكمبيوتر ل عمر خمسطعشر سنه؟	ما هي أحدث ألعاب الكمبيوتر لفتى سنه خمسة عشر عاما ؟
عنبسرك بكره.	سنراك في الغد .
معك اي خبز؟	هل لديكم أي خبز ؟
كيف انت بالكمان؟	ما هو مستوى مهارتك في عزف الكمان ؟
صاحبي طحس وادرب للقاع بالحمام.	لقد انزلقت قدما صديقي وسقط في الحمام .
المسيحيه ممنوعه والبلاد غلقت ابوابها على بقيه العالم.	حظرت المسيحية وأغلقت البلاد بالنسبة لبقية العالم .
كم تشتي؟	ما الكمية التي تريدها ؟
كوكتيل جمبري لها ونفس الشي لي.	خلطة جمبري لها ، وكذلك لي .
شخارك مزعج.	إن غطيطك مزعج .
ممكن شويه بيبار؟	هل لي في بعض الفلفل ؟
انا مستر تاكهاشي في غرفه خمسه تسعه واربعين. تقدر ترسل اربع قوارير بيره بدويسير، لو سمحت؟	أنا السيد تكاهاشي بالغرفة رقم خمسة تسعة وأربعين . من فضلك أرسل أربع زجاجات من بيرة بودفايزر .
اشتي اتصال تقومني على الساعه ثمان ونص بكره الصبح، لو سمحت.	أريد مكالمة لإيقاظي في الثامنة والصف صباح غد ، من فضلك .
ايوة، بس هذا خيرات قوي و انا قد انا ملان.	أجل ، ولكن هذا كثير جدا ، ولقد شبعت بالفعل .
اشتي شويه غسول فم.	أريد غسيلاً للفم .
بين احس ان انا مش بخير.	أشعر بوعكة .
تدي خصومات بالجمله؟	هل تقدمون تخفيضات كبيرة ؟
طوكيو صفر ثلاثه اربع تسعات اربعه خمسه سته سبعه.	طوكيو صفر ثلاثة أربعة مرات تسعة أربعة خمسة ستة سبعة .
تقدر تساعدني الاقي حديقه الحيوانات؟	فضلا ، ساعدني في العثور على حديقة الحيوان .
عتقل لي كيف اعدله؟	هلا أخبرتني كيفية تعديلها من فضلك ؟
تعرف كيف تستخدم التلفون؟	أرني كيفية استعمال الهاتف .
اكيد. معانا علامات كتب امريكيه اصلية حاليه.	بالتأكيد . لدينا بعض الماركات الأمريكية الأصلية الجميلة . للكتب .
عامل مكالمات بيتحاكى ياباني، لو سمحت.	أريد عامل تشغيل يتحدث اليابانية من فضلك .
احنا مهتمين بالموضه.	نحن مهتمون بالأزياء .
ممكن تدي لي حبل؟	هل يمكنك أن تجر سيارتي ؟
هذه عيادة اف؟	أهذه عيادة إف ؟
ايحين عنوصل لوس انجلس؟	متى نصل إلى لوس أنجلوس ؟
امشي طوالي لحوالي خمس دقايق، ولف يسار.	سر في نفس الاتجاه حوالي خمس دقائق ثم لف لجهة اليسار .
من هذا الطريق لجهه الشاطئ.	إنه في هذا الطريق في اتجاه الشاطئ .
هذا شاي الاعشاب يساعد على تجديد الجسم.	هذا الشاي العشبي يساعد الجسم على استعادة نشاطه .
هذلا مشن مصنوعات في اليابان، او ماشي؟	لم تصنع هذه باليابان ، أليس كذلك ؟
تمام. هذا الطريق لو سمحت. شا اوريك لغرفتك.	حسناً . خذ هذا الاتجاه . من فضلك ، سأوصلك إلى غرفتك .
ضروري اخرج من الفندق قبل ظهر.	علىّ مغادرة الفندق قبل الظهر .
اثنين برجر و اثنين قهوة، لو سمحت. اشتي اشلهن لخارج.	نريد اثنين هامبورجر واثنين قهوة ، من فضلك ، نريد تناولها خارج المحل .
ممكن اشل هذلا الشنطتين؟	هل يسعني أن استمر في حمل هاتين الحقيبتين ؟
ابني منهك تماما.	إن طفلي قد أصابه الإعياء الشديد .
انا تاعب لبطني.	أشعر بالغثيان .
هذا الجاكت مشو مقاسي.	هذا الجاكت ليس مقاسي .
اشتي اقابل مستر ويليام.	أريد لقاء السيد ويليم .
يحتوي على سبع فيتامينات و معادن.	إن بها تشكيلة من سبعة فيتامينات ومعادن .
اقدر اشل الزلط لمن ارجع اليابان؟	هل سأسترد ما أنفقت عند عودتي إلى اليابان ؟
من ايش معمول هذه الطبخه؟	ما هي مكونات هذا الطبق ؟
من اين اقدر اشل رمز مترو الانفاق؟	من أني يمكنني الحصول على مسكوكة لركوب المترو ؟
بيرتسل لك عشرين عينه اضافيه.	سنبعث لك بالبريد عشرين عينة إضافية .
ما اعتقدش ان هذا لي لانه بشرتي جافه نوعا ما.	لا أعتقد أن ذلك يناسبني فجلدي جاف إلى حد ما .
تسعه-وتسعين دولار بالساعه على الجاهل.	تسعة وتسعون دولاراً في الساعة للطفل ؟
لازم يكون هادئ.	لابد أن تكون هادئة .
مفتاح الغرفه، خمسه صفر ثلاثه، لو سمحت.	أريد مفتاح الغرفة خمسة صفر ثلاثة ، من فضلك .
اين الصالون؟	أين الحلاق ؟
الساعه سبع، لو سمحت.	في الساعة السابعة ، من فضلك .
شنطتي اتخربت.	لقد أتلفت حقيبتي .
سياحه.	لمشاهدة المعالم .
انا من اسبانيا.	إني من إسبانيا .
ارسل هذا ببريد جوي لليابان، لو سمحت.	أرجو أن تبعث هذا بالبريد الجوي إلى اليابان .
احنا على ارتفاع اثناعشر الف قدم.	إننا على ارتفاع اثني عشر ألف قدم .
اولا، نشتي نبسر شارع وول.	في البداية نود مشاهدة وول ستريت .
اين محطة الباصان حق اوكسفورد؟	أين محطة الحافلة التي تقصد أكسفورد ؟
شا اراعي لوما تفضى البلكونه.	سأنتظر حتى يتاح الجلوس في التراس .
عتكتب عنوانك هانا؟	هل يمكنك كتابة عنوانك في هذا المكان ؟
لو سمحت قل لي اين اقرب صيدليه هانا.	أخبرني من فضلك أين أقرب صيدلية .
لحقي الفندق، لو سمحت. عنوان الفندق هانا.	إلى فندقي ، من فضلك ، إن عنوان فندقي في هذه الورقة .
ارفع السماعه وراعي شويه لو سمحت.	ابقى على الخط وانتظر لحظة من فضلك .
ايش عادة تفعل بالبيت بعد العشاء؟	ماذا تعمل في المعتاد بالمنزل بعد تناول العشاء ؟
عتوقع بالبيت على حوالي ثلاث.	ستكون بالبيت في حوالي الثلاثة .
زياده شويه.	زدني قليلاً .
من اين بيتحركين باصات السياحه؟	من أين تغادر الحافلات لمشاهدة المعالم ؟
الين الياباني تمام؟	هل تقبل بالين الياباني ؟
معك موستانق؟	هل لديك سيارة من طراز ستانج ؟
احنا عنقفز من هانا؟	هل سنقفز من هنا ؟
مستر كاواي، معانا لك الان طاوله. جي من هانا، لو سمحت.	يا سيد كاواي لدينا مائدة لك الآن . تفضل من هنا .
تقدر تطرحني في فندق هيلتون، لو سمحت؟	هلا أنزلتني عند فندق هلتون من فضلك ؟
طاوله لغير المدخنين، لو سمحت.	مائة غير المدخنين من فضلك .
ممكن تقل لي قبل ما نوصل ل دورهام؟	هلا أخبرتني قبل أن نصل إلى درهام ؟
هذا مشو صح. انت دايما بتعالجني.	ليس هذا صحيحاً . أنت دائما تعاملني .
اتهجيها، لو سمحت.	تهجى الكلمة من فضلك ؟
قد انا بين اسكر من الخمر.	بدأت الخمر تثملني .
اوبه لانه الجو بيتغير قوي بالجبال.	احترس لأن الجو في الجبال شديد التقلب .
شيك سياحي و ين ياباني، تمام؟	هل يمكن استخدام شيكات سياحية وعملة ين ياباني ؟
اسف، بحثت عند الاثنين خدمه الغرف و قسم المفقودات. مش هو معاهم.	آسف ، لقد تحققت من إدارة الخدمة وإدارة المفقودات ولم أجدها عندهم .
هو مكان صعب نلقاه. هو في شارع صغير خارج الطريق السريع الرئيسي.	يصعب العثور على هذا المكان . إنه في طريق ضيق يتفرع من الطريق الرئيسي .
ما اعرفش حاجه عنه.	لا أعرف شيئاً عن هذا الأمر .
نقدر نتحاكى عليه في كافيه.	يمكن أن نتحدث حول هذا الموضوع في مقهى .
بين ابسر، في هذه الحاله مش انا مضطر ادفع رسوم التغيير، صح؟	فهمت ، في هذه الحالة ليس علىّ أن أدفع أجر التبديلات ، أليس كذلك ؟
عامل المكالمات، لو سمحت.	اعطني عامل التليفون من فضلك .
ممكن توطي السرج، لو سمحت؟	هل يمكن أن تنزل السرج ، من فضلك ؟
طيب. شا اشل بس ثنتين. شكرا.	حسناً . سوف أخذ اثنين فقط . شكراً .
هيذا هاه فاتورتك. هي ثلاثمية وسبعة وتسعين دولار.	هاهي فاتورتك . الحساب ثلاثة تسعة وسبعين دولار .
اشتي استاجر تيه السياره ب اربعه وعشرين ساعه.	أود تأجير هذا الطراز من السيارات لمدة أربعة وعشرين ساعة .
كان قوي حالي ان انا قابلتك.	كم كان لطيفاً أن التقي بك .
قدوة مشطوط.	إنه ممزق .
طيب، تخيل كم عياخذ عمله وقت اطول لو سأل سؤال واحد زيادة لكل شخص. هيا نسرع ندي حقنا الشنط. لازم نسير للجمارك بعد.	حسنا ، تصور كيف ستطول فترة عمله لو سأل سؤالاً آخر لكل شخص . هيا بنا ، لنسرع ونحضر حقائبنا . علينا الذهاب إلى الجمارك للإعلان عن أغراضنا بعد ذلك .
ايش هو الوزن؟	ما هو الوزن ؟
به هانا مطعم صيني قريب؟	هل يوجد بالقرب من هنا مطعم صيني ؟
منصه خمسه هي هاناك.	إن الرصيف رقم خمسة يقع هناك .
ايحين هي مباراه كره القدم؟	متى تقام مباراة كرة القدم ؟
أعتقد أن به شوية أخطاء في الفاتورة.	أعتقد أن هناك أخطاءً في الفاتورة .
لو سمحت اديلي هذا.	من فضلك اعطني هذه .
هي البوابه السابعه.	إنها البوابة السابعة .
أنت اسكتلندي؟	هل أنت اسكتلندي ؟
ثلاثه-اثنين-واحد-اثنين. راعي ثانيه، تمام؟ أشتي ارسلك حاجه هانا. عفوا.	ثلاثة اثنان واحد اثنان . انتظر ثانية ، حسنا ؟ أريد أن أرسل لك شيئاً هنا . معذرة .
الفوط القصار مع البواتي مستحيل يخرجين عن الموضة.	إن الجونلات القصيرة ومعها الأحذية الطويلة لن تنقضي موضتها .
ممكن أحاكي المدير؟	هل أستطيع التحدث مع المدير ؟
ليش أجرتك غير الذي في العداد؟	لماذا يختلف السعر عن الموجود في العداد ؟
ممكن أبسر هذا؟	هل يمكن أن أرى هذا ؟
وعدت نفسي أنني لما أبسرك، أنني شتعرف عليك.	لعد تعهدت لنفسي بأنني سوف أتعرف عليك عندما أراك .
أيش بيحصل لهذا الوقت المتأخر؟	ما الذي كان يحدث منذ الفترة الأخيرة ؟
بينحس أنني مش بخير. ممكن تقترح عليا دكتور؟	لا أشعر بحالة جيدة . هل ترشدني إلى طبيب ؟
الطرف الثاني على الخط. اتفضل.	حفلتك مقامة الآن . تفضل .
به عرض على الارض؟	هل هناك عرض ترفيهي ليلي ؟
اشرب هذا العلاج بعد كل وجبة لما يوجعك قوي.	خذ هذا الدواء بعد كل وجبة عندما يزداد الألم .
أطرح الزلط في ظرف مميز مزين يسموه شوجيبوكورو.	لقد وضعت المال في مظروف خاص مزين يسمى شوجيبوكورو .
معك خريطه للمترو؟	هل لديك خريطة لمترو الأنفاق ؟
أنا ماناش قوي في الألماني.	لا أحسن الألمانية كثيراً .
لازم نرجع جمعه مره ثانيه.	لابد أن نجتمع ثانية بالتأكيد .
ممكن أتسلف مضرب وكرات؟	هل يمكنني استعارة مضرب وكرات ؟
ممكن تديلي نص قارورة؟	هل يمكن أن أخذ نصف إبريق ؟
حيا. أنا جون.	تحية . أنا جون .
ناكاي.	ناكاي .
عندك مانع اذا صورتك أنت وحقك التاكسي؟	هل تمانع إذا التقطت صورة لك ولسيارتك الأجرة ؟
في البزنس. معي صلات تجاريه هانا.	في عمل . لدي صلات عمل هناك .
ممكن لو سمحت تنتبه لحقي الشنطه؟	هلا راقبت حقيبتي من فضلك ؟
كيف تحب هذه الفكرة؟ عنقبل شرطك بإشعار ستة شهور بشرط تديلنا الحق بالبيع لستة شهور بعد انتهاء العقد.	كيف تحب هذه الفكرة ؟ نحن نقبل بشرطك الذي ينص على فترة بلاغ مسبق قدرها ستة اشهر شريطة أن تمنحنا الحق بالبيع لمدة ستة أشهر بعد إنهاء العقد .
عفوا، تعرف نيويورك سوى؟	معذرة . هل تعرف نيويورك جيدا ؟
اشي ابسر جراح.	أود زيارة جراح .
أشتي أركب في سيارة رياضية.	أريد أن أركب في سيارة رياضية .
رمز المنطقه صفر ثلاثه. الرقم هو واحد اثنين ثلاثه أربعه خمسه سته سبعه.	كود المنطقة هو صفر ثلاثة . والرقم هو ثلاثة واحد اثنان ثلاثة أربعة خمسة ستة سبعة .
استبرد.	لقد أصيب ببرد .
أشتي أرسل هذا التوصيل العادي.	أريد أن أرسل ذلك بطريقة التوصيل العام .
خليني أحول هذا الاتصال للرجال المسؤول.	دعني أحول هذه المكالمة إلى المسئول .
أيش من مقاس تشتي؟	أي مقاس تريد ؟
يو، ياعزيزي. ما كنتش داري أن عاد معي هذلا.	أوه يا عزيزي . لم أدرك أنني لازلت لدي هذه الأشياء .
معك مجموعه صناديق لارسال الطرود؟	هل ليدكم صناديق لإرسال الطرود ؟
كل هذلا حقك الشنط؟	هل هذه كلها هي حقائبك ؟
كيف تشتي تفعل هذا الاتصال؟	كيف ترغب في إجراء المكالمة ؟
طيب، هذا غالي. مشو مصنوع في اليابان. صح؟	حسنا ، إنه باهظ الثمن . إنه لم يصنع في اليابان ، أليس كذلك ؟
ممكن تمكني الملح؟	هلا مررت لي الملح ، من فضلك ؟
أينو أقرب مطعم من هذا الفندق؟	أين أقرب مطعم لهذا الفندق ؟
أشتي شامبو للشعر العادي.	أريد شامبو للشعر العادي .
أيحين تعتقد أنهم عيلاقوه؟	متى تعتقد سيتم إيجادها ؟
أتمنى لك سنه جديده سعيدة.	أتمنى لك عاما سعيدا جدا .
الطيران عيدفع لحقي الفندق و قيمة الوجبات.	سوف أتناول زجاجة سبرايت كبيرة .
عفوا، أشتي أطلب طلب.	معذرة . أريد أن أطلب طلب .
معي ثلاثه عيال.	عندي ثلاثة أطفال .
أخطى طوالي لنهايه هذه القاعه ولف يسار عند الركن . عتبسره على يمينك.	سر للأمام إلى آخر هذه القاعة وانعطف يسارا عند الركن . سوف تجدها على يمينك .
كم بتكلف تذكره سيره وجيه ل اكسفورد؟	كم تبلغ تكلفة تذكرة ذهاب وعودة إلى أوكسفورد ؟
انا اسير لنادي رياضي كل يومين.	اذهب إلى نادي رياضي كل يومين .
أين شقدر أجلس خلال الرحله؟	أين يمكنني أن أقيم أثناء الجولة ؟
أيشو وقت الخروج؟	ما توقيت إجراءات مغادرة الفندق ؟
بكم المرشد باليوم؟	كم يتقاضى المرشد في اليوم ؟
من اين شا اقدر احصل سيديهات؟	أين أجد الاسطوانات المدمجة ؟
ممكن تقل لنا كيف بتقيم هذه الخطه؟	هل من الممكن أن تخبرنا كيف تقيم هذه الخطة ؟
كاش او على الحساب؟	نقدا أم ببطاقة الائتمان ؟
بينشتغل في شركة تدريب.	أعمل في شركة تجارية .
مشو من الادب انك تسال الناس كم بيستلمو.	ليس من الأدب أن تسأل الناس كم يتقاضون .
هل هذولا ليفيز خمسمية وواحد اصليات؟	هل هذه من نوع ليفي خمسة صفر المعتمدة ؟
أيش من وقت أقدر أتحمم؟	متى يمكنني أن آخذ حماما ؟
ما يبانش عليك ان عمرك واحد وعشرين سنه.	لا تبدوا أكثر من إحدى وعشرون سنة من العمر .
بين ابسر. بالحقيقه، حقها الفلم عالي السرعه. عندك مانع اذا خرجته؟	أفهم . في الواقع إنه به فيلم عالي السرعة . هل تمانع إذا أخرجته ؟
أشتريته الان.	اشتراها الآن فقط .
شدي واحد الان.	سوف أحضر واحدة في الحال .
ثمانيه دولار. وهذه واحده الان.	ثمانية دولارات . وهنا تأتي واحدة حالا .
به هانا اي محلات شاملة عاملين الان تخفيضات؟	هل أي من المتاجر الكبيرة به يعمل الآن ؟
عامل المكالمات، وصلني ب محطه الحريق.	يا عامل الاتصال ، وصلني بمحطة الإطفاء .
معي بطاربه عتنتهي.	لقد حصلت على بطارية فارغة .
اوه، هوذا هاه. و ضروري كل يواحد يعبي استماره البيان الجمركي؟	آه ، ها هي . هل ينبغي على كل شخص أن يملأ استمارة الإقرار الجمركي هذه ؟
و ممكن اسمك لو سمحت؟	ممكن أعرف اسمك من فضلك ؟
عندك مانع لو اتصل اتصال على حساب المتلقي؟	هل من الممكن إجراء اتصال على أن يتم تحصيل أجرته من الطرف الآخر ؟
سلام. كيف حالك؟	مرحبا . كيف حالك ؟
ابسر هذا، ابسر هذا. عتقولي ان الفرق بين هذا الرجال وهذاك الرجال هو الحظ؟ محمد، جنب لوسمحت. عادي لو نزلتك هانا. انا قدنا متأخر ياخي. فرصة سعيدة، تمام؟	أنظر إلى هذا . انظر إلى هذا . سوف تخبرني أن الاختلاف بين هذا الشاب وذلك الشاب هو الحظ ؟ محمد ، يقف بالسيارة في جانب الطريق ، وأنت ؟ لن تمانع في أن أنام معك هنا . أنا متأخر . كان لقاء جميل معك ؟
به اي رسايل لي؟	أية رسائل لي ؟
نشتي غرفه بالخلف.	نريد غرفة في الخلف .
شكلك حالي.	تبدو جميلا .
تبعد حوالي تسعه وتسعين ميل.	إنها تبعد حوالي تسعة وتسعون ميلا .
لو سمحت خلي هذه الشنط مربوطة.	من فضلك احفظ هذه الحقائب في محتجز الجمارك .
انا اسمي ساتو.	اسمي ساتو .
انا اعرف نادي جاز قديم وسطه المدينه.	أعرف نادي قديم لموسيقى الجاز بوسط البلد .
اشتي هذه الوجبة الرئيسية.	سأتناول هذه الوجبة .
هذا بيطلع للدور السادس؟	هل يصعد هذا إلى الدور السادس ؟
لو سمحت اطرحه في كيس غسيل وخليه هاناك.	من فضلك ضعه في كيس الغسيل و اتركه هناك .
اشتي هذا الفلم يكون جاهز. ايحين عيكون جاهز؟	أود تحميض هذا الفيلم . متي سيكون جاهزا ؟
الطاقه تمام.	النافذة جيدة
خلي نبعتي لانازل، لو سمحت.	اجعل قصة الشعر تتدلى لأسفل , من فضلك .
هل بيشمل كل مصاريف النقل؟	هل تم إدراج جميع تكاليف النقل ؟
اين هو مكتب اجر-سياره؟	أين مكان تأجير السيارات ؟
ايش معك من خضروات؟	ما أنواع الخضراوات الموجودة لديك ؟
هذا اللون الغلط.	انه اللون الخاطئ .
السنه اكتسرت.	لقد انكسرت السنة .
هذا مقعد على الممر او عند الطاقه؟	هل هذا المقعد بجوار الممر أم بجوار النافذة ؟
انا ما بين امشيش رجل.	أنا في نزهة طويلة سيرا على الأقدام .
وريني واحده ل شابه.	أرني واحدة لإحدى الشابات .
تقدر تسحب ل هانا؟	هل يمكنك أن تتحرك بهذا الاتجاه ؟
بدون حليب، لو سمحت.	بدون حليب , من فضلك .
اين هي البحيره؟	أين البحيرة ؟
ممكن اشل مجله او اي شي؟	هل يمكن أن احصل على احدى المجلات أو شيئ من هذا القبيل ؟
هو جنوب.	انها باتجاه الجنوب .
بكم مقاعد اللي بالبلكونه؟	ما تكلفة المقاعد الخاصة بالشرفة ؟
طيب. شا اشلك لاهاناك.	و هو كذلك . سأوصلك إلى هناك .
الجزء المكتوب بالمائل يشير الى التغييرات الي وقعت بالتسعينات.	الجزء المكتوب بالطريقة المائلة يشير إلى التغييرات التي حدثت في التسعينات .
هو عمره ثلاثين سنه.	أنه يبلغ من العمر ثلاثون عاما .
اشتي اسير ل هاررودز. ممكن ترسم لي الخريطه، لو سمحت؟	أود الذهاب إلى محل الهارودز . هل معك خريطة , من فضلك ؟
ايش بتفعل في وقت فراغك؟	ما ذا تفعل في وقت فراغك ؟
معك بطاريات لهذلا الكيمرات؟	هل لديك أحجار بطارية لهذه الكاميرا ؟
اشتي كيبل تصوير عن بعد.	أود إرسال برقية لاسلكية .
انت الاخير بهذا الطابور؟	هل أنت الأخير في هذا الصف ؟
اعتقد انه قدوة كله محجوز.	أعتقد أن الحجز قد زاد عن العدد .
رميه سابره. خارج بالضبط.	ركلة موفقة . كادت تدرك الهدف .
ممكن تقل لي على الاماكن الحاليه هانا؟	هل يمكن أن تخبرني عن الأماكن الشيقة هنا ؟
به هانا محلات شاملة قريبه هانا؟	هل يوجد أي محل متعدد الأقسام قريب من هنا ؟
اشتي انضم من سان ديغو.	أود اللحاق بالسفر من سان دييجو .
كنت بين افكر اشل هذاك الكورس الترم الجاي.	كنت أفكر في الحصول على هذه الدورة في فترة نصف العام المقبلة .
الخمر ماهو بارد كفايه. عتخليه يبرد اكثر؟	النبيذ ليس باردا بشكل كافي . هل نمكنك أن تجعله أكثر برودة ؟
ب ايش انت مهتم اكثر شي الان؟	ما هي أكثر الأشياء التي تثير اهتمامك الآن ؟
تقريبا ما شا اقدر احصل مشروب نفس هذا ب اي بقعه.	ربما لا يمكنني أن أتناول مثل هذا المشروب في أي مكان آخر .
لو تشتري هذه والكل، عيوقع معفى من الجمارك.	إذا اشتريت هذا أيضا , فستعمل للمبلغ الذي يعفي من الرسوم .
ممكن ابسر شهاده التلقيح حقك، لو سمحت؟	هل يمكنني أن أطلع على شهادة التطعيم الخاصة بك , من فضلك ؟
انت بتسافر خيرات؟	هل تسافر كثيرا ؟
معي تذكره طيران ل سان فرانسيسكو.	معي تذكرة طيران إلى سان فرانسيسكو .
اذا هي خمسطعشر دقيقه من المحطه، انا شا امشي رجل.	لو إن المسافة خمسة عشرة دقيقة فقط من المحطة ، إذن سأمشيها .
اشتي فندق ارخص ب شويه.	أريد فندق أرخص قليلاً .
فيني صداع.	مصاب بالصداع .
اشتي شهاده طبيه و فاتوره للتامين حقي.	أريد شهادة طبية وإيصال من أجل التأمين الخاص بي .
ليش الطايره ماقد اقلعتش؟ قل لي ما بيحصل.	لماذا لم تقلع الرحلة ؟ أخبرني عما يجري .
اشتي استاجر كرسي على ظهر السفينه.	أريد استئجار كرسي مركب .
راعي دقيقه، لو سمحت.	انتظر دقيقة من فضلك .
لا تلمسني.	لا تلمسني .
معك شقاره؟	هل معك سجائر ؟
اذا الريح مش هيه قوي قويه، عنقدر نسير لتيكي بوينت.	يمكننا الذهاب إلى نقطة تيكي إذا لم تكن الريح قوية .
يجنن.	رائع .
شا اغلق الان. شكرا لانتباهك.	سأغلق الآن . شكراً على انتباهكم .
من هو؟	من هذا ؟
عفوا. ممكن تقل لي اين موقف التكاسي؟	معذرة . هل لك أن تدلني على مكان موقف سيارات الأجرة ؟
هوذا هاه.	هاهي .
اين اقرب محل اجهزه؟	أين يوجد أقرب متجر لأجهزة الكمبيوتر ؟
ممم. ما بيشتغلش، صح؟ تقدر تنقل ل مقعد فاضي، اذا تشتي.	هه . إنها لا تعمل ، أليس كذلك ؟ يمكنك الانتقال إلى مقعد شاغر إذا كنت تريد ذلك .
انا بين ادور على ذيه.	إنني أبحث عن هذا .
عربة والا بولمان؟	حافلة عادية أم حافلة مجهزة للنوم ؟
الاسم هو جورو موتوياما. والرقم هو صفر ثلاثه ثلاثه اثنين سته واحد اثنين اربعه تسعه خمسه.	الاسم هو جورو موتوياما . والرقم هو صفر ثلاثة ثلاثة اثنان ستة واحد اثنان أربعة تسعة خمسة .
بين احسن ان انا تاعب قوي.	أشعر بمرض شديد .
"ايش اوقات عرض ""كوسيز لف""؟"	"ما موعد عرض "" قصة حب كوسي "" ؟"
طيب. تشتي قهوتك الان او بعدين؟	حسناً . هل ستحتسي القهوة الآن أم فيما بعد ؟
قل لي اقوى نادي ريغغي في نيو يورك.	دلني على أكثر نوادي موسيقى الريجاي إثارة في نيويورك .
هل هو عادي انه محد بيسمع لتعليمات السلامه؟	هل من المقبول عدم اتباع أي شخص لتعليمات الأمن ؟
هل الشارع الخلفي خطير؟	هل الشوارع الخلفية خطر ؟
ايوة. لو سمحت اعمل الاجراءات اللازمه.	أجل . من فضلك اتخذ الإجراء الضروري .
احنا نفضل طاوله جمب الطاقه.	نفضل مائدة بجوار النافذة .
لو سمحت قل لي عن ارخص طريقه اسير بها ل سان فرانسيسكو.	من فضلك دلني على أرخص وسيلة للذهاب إلى سان فرانسيسكو .
انت تعرف المطعم، كيويا؟	هل تعرف المطعم يا كيويا ؟
اتجاه واحد.	اتجاه واحد .
به هانا نادي ليلي حالي مع عرض الفلامينكو؟	هل يوجد ملهى ليلي جيد به عرض رقصة الفلامنكو ؟
الفستان اللي لابسه له حالي.	جميل الفستان التي ترتدينه .
ارجلي بيوجعني.	قدمي تؤلمني .
مقاعدنا اتفرقين.	تم الفصل بين مقاعدنا .
الفاتوره توصل لميه دولار.	وصلت الفاتورة لمائة دولار .
طيب، حجزك مؤكد.	حسناً ، تم إعادة التأكيد على حجزك .
الكعب قوي عالي.	الكعب مرتفع جداً .
نشتي طاوله في البلكونه.	نريد مائدة في الشرفة .
هذا يعني ان الفلم الليله ما عيوقعش مناسب للاطفال تحت الخمسطاعش. لذلك الاباء لازم يطرحو في اعتبارهم يخلو الجهال يبسرو الفلم او لا.	هذا يعني أن الفيلم ربما يكون غير مناسباً للأطفال تحت سن الخامسة عشر . لذلك فإن الآباء بحاجة إلى الأخذ بعين الاعتبار إذا ما كانوا سيدعون الأطفال يشاهدون الفيلم .
كيف تشتي الزلط؟ لو سمحت عبي الورقه ووقع هانا.	كيف تريد النقود ؟ من فضلك املأ هذه الورقة ووقع هنا .
بعض الاحيان بطني توجعني.	تؤلمني معدتي أحياناً .
معك اطباق السعرات الحراريه حقه قليله؟ انا عامل ريجيم، الان.	هل لديكم أطباق ذات سعرات حرارية منخفضة ؟ فأنا أتبع نظاما غذائياً حالياً .
ايوة، معي تذكرتين ل جاينتس و دودجرز.	"أجل ، معي تذكرتان ل "" العمالقة "" و "" المحتالين "" ."
شكرا. حتى انا. معسلامه لوقتها.	شكراً . وأنا أيضاً . إلى اللقاء فيما بعد .
نكعت بالدرج.	لقد سقطت من على درجات السلم .
شريحتين و سبرايت.	شريحتين وزجاجة سبرايت .
ايوة، انا. كانو عايشين جمبي في كاليفورنيا لكن انتقلو لفلوريدا قبل سنتين. وانت كيف؟ عتسافر لوحدك؟	أجل ، أنا . لقد كانوا يعيشون بجواري في كاليفورنيا لكنهم انتقلوا إلى فلوريدا منذ عامين . ماذا عنك ؟ هل تسافر بمفردك ؟
انا تاعب.	أنا مريض .
طفلي شكله تاعب من الحمى.	يبدو طفلي منهكاً بسبب الحمى .
طلبات المزايا الثقافيه بيدوهن للفنانين والعلماء المميزين في هذا اليوم.	تمنح أوسمة الاستحقاق الثقافي للفنانين والعلماء المتميزين في هذا اليوم .
انا ياباني.	أنا ياباني .
ايوة. شل باص اللي بيسير ل كيوتو-ايكي.	أجل . استقل الحافلة التي تذهب إلى محطة كيوتو .
هي للاعضاء بس؟	هل هذا للأعضاء فقط ؟
اقدر اشل هذلا لفوق الطايره؟	هل يمكنني أن أحضر هذا على متن الطائرة ؟
طيب. كل اللي اشتي اعرفه اذا البزنس بيدفع بطريقته.	حسناً . كل ما أريده هو معرفة إذا ما كان المشروع سيحقق ربحاً .
عادي. تشتي مقرمه تناسب هذا؟	جميل . هل تريدين إيشارباً يتناسب مع هذا ؟
اشحن البطاريه، لو سمحت.	أعد شحن البطارية من فضلك .
صدق. اليوم احد، والاحد اخس يوم.	حقاً . اليوم هو الأحد ، والأحد هو أسوء الأيام .
ايوه، هي مشكله التخلص من القمامه.	أجل . إنها مشكلة تخلص من الفضلات .
اشتي هذه النقشه لوضع بخمس مجالس.	أريد هذا الطراز لخمسة أماكن مرصعة .
"اوه. هذه الفضه نادره ""القمر والجرس"". اكيد تشتي تبدلهن؟"	"آه . هذه الفضية نادرة "" القمر والجرس "" . هل تريد أن تغيرها أكيد ؟"
امي واختي عيجو من اليابان عسب يبسروني. عيوصلو هانا حوالي سبع الليل.	أمي وأختي قادمتان من اليابان لرؤيتي . سيصلان هنا حوالي السابعة مساءً .
البني قوي مشهور هذه السنه.	اللون البني محبب هذا العام .
طيب. مقعدين، لو سمحت.	حسنا . مقعدان من فضلك .
اين هو السوق؟	أين السوق ؟
انا مراعي اجرب بدل السباق الجديده.	أود قياس بذلة السباق الخاصة بي .
بكم تذكرة الدرجه الاولى ل ايدنبره، لو سمحت؟	ما سعر تذكرة درجة أولى إلى إدنبره , من فضلك ؟
شكل ان الزلط اللي جبتها لي عشرة دولار بالضبط.	يبدو أن النقود التي أعطيتني إياها ناقصة عشر دولارات .
عاد انا اتصلت ل مستر سميث في غرفه اثنين صفر واحد، لكن محد رد. ممكن تبسر اذا عاد هو بيجلس هانا؟	لقد اتصلت بالسيد سميث في غرفة رقم اثنان صفر واحد منذ لحظات ، لكن لم يرد أحد . هل لك أن ترى هل لا يزال يقيم هنا ؟
اشتي واحده حديثه.	أريد واحدة حديثة .
بين اشتغل لشركه نشر.	أعمل في شركة نشر .
ممكن لو سمحت تعبي هذا؟	هل لك أن تتفضل وتملأ هذه ؟
ايش يسمو هذا بالانجليزي؟	ماذا تسمون هذا بالإنجليزية ؟
امشي طوالي على هذا الممر، بعدين بتلاقيه على جهه اليمين.	ظل سائراً عبر هذا الممر , وستجدها على الجانب الأيمن .
اشتي ااكد هذا.	أريد التأمين على هذا .
ايوة، نقدر نخدمك من الساعة سبع.	أجل , يمكننا القيام بخدمتك بداية من السابعة .
لوسمحت تمدد هانا.	من فضلك استلق هنا .
يمكن عادهو عيرجع يظهر.	ربما ستظل ترتفع .
لو سمحت لف يسار بالتقاطع الجاي.	من فضلك اتجه يساراً عند التقاطع التالي .
به خدمة باصات لمتحف فورد؟	هل توجد خدمة نقل بالحافلات إلى متحف فورد ؟
ايوة. اسمك ورقم غرفتك لوسمحت.	أجل . اسمك ورقم غرفتك , من فضلك .
طيب. أشوفك الساعة ثنتين يوم الأحد.	حسناً . أراك الساعة الثانية يوم الأحد .
اشتي اسير عبر نيويورك لا تورونتو.	أريد أن أمر بنيويورك في طريقي إلى تورونتو .
السستة مكسورة. معك ثانيات نفسه؟	لقد كسر الزمام المنزلق . هل لديك مزيد من نفس النوع ؟
هذا كأنو وسخ.	هذا ضرب من الدناءة .
اقدر اشل شوكة جديدة؟	هل لي بشوكة أخرى ؟
شكرا جزيلا على لطفك.	شكراً جزيلاً لعطفك .
عفوا، ما نبيعش تذاكر للمسرح.	آسف ، نحن لا نبيع تذاكر للمسرح .
اشتي ابسر هذا.	أريد أن أرى هذا .
ها، هذا حالي. ايش لازم اعمل؟	آه ، هذا جميل . ماذا علي أن أصنع ؟
لوسمحت غير مقعدي.	من فضلك غير مقعدي .
معانا جمبري حالي قوي اليوم.	لدينا جمبري رائع جداً اليوم .
للساعة كم هو فاتح؟	إلى أي ساعة متأخرة تظل مفتوحة ؟
للمدخنين او لغير؟	للمدخنين أم لا ؟
غالي قوي عليا. ما تقدرش ترخصه؟	إنه غالي جدا بالنسبة لي . ألا يمكنك تخفيض السعر قليلاً ؟
انا ما عملتش حجز.	لم أقم بالحجز .
تقدرتتصل بتكسي لي الساعة ثمان غدوة الصبح؟	هل لك أن تستدعي لي سيارة أجرة الساعة الثامنة صباح غد ؟
ليش ما نراعي للباص تحت المظلة؟	لماذا لا ننتظر الحافلة تحت التندة ؟
تعال يا كينجي. جي اعملك لفة حول المكتب.	تعالى ، كينجي . دعني أريك أرجاء المكتب .
ايوة، هو مفتوح من تسع لا تسع.	أجل ، إنها مفتوحة من التاسعة حتى التاسعة .
انا معي موعد ثاني.	لدي موعد آخر .
معي خريطة طرق للمدينة؟	هل لي بخريطة لطرق المدينة ؟
ما فهمتش شرحك.	لا أفهم شرحك .
هل هو متين؟	هل هي متينة ؟
استمتعت بوقتي قوي.	لقد استمتعت كثيرا .
طيب اذا، اشتي يوقع معي وجه صغير ساع جوليا روبرتس.	حسنا إذاً ، أريد عصا مضرب أصغر كتلك التي مع جوليا روبرتس .
تقدر تشل هذا لوسمحت؟	هل لك أن تأخذ هذا ، من فضلك ؟
الراكبين المسافرين على طيران ايه بي سي الرحلة سبعة صفر ثلاثة متجهة الى طوكيو لوسمحتوا تقدموا الى البوابة رقم عشرين للاجرائات الحكومية.	الركاب المسافرون على خطوط إيه بي سي الجوية رحلة رقم سبعة صفر ثلاثة المتجهة إلى طوكيو التفضل بالتوجه إلى بوابة رقم عشرين لإنهاء الإجراءات الرسمية .
وين محطة الباص حق بي؟	أين موقف الحافلات ل بي ؟
في الفردي، لوسمحت.	الدخول فرداً فردا ، ً من فضلكم .
اقدر اوظف مرشد يتحاكى ياباني؟	هل يمكنني استئجار مرشداً يتحدث اللغة اليابانية ؟
تشتيني اشل صورتك؟	هل تريدني أن ألتقط لك صورة ؟
ما حصلتش هذا الطبق.	لم يكن لدي هذا الطبق .
قطعت اصبعي. به مطهر؟	لقد قطع إصبعي . هل يوجد مطهر ؟
ممكن تدي لي طابع ابو خمسه-وتسعين؟	هل يمكنني الحصول على طابع فئة خمسة وتسعين سنتاً ؟
شا اكون هانا على ثمان الا ربع.	سأكون هنا الساعة الثامنة إلى الربع .
اشتي شويه عطر.	أريد عطراً .
ممكن تدي لي جدول زمني؟	هل لي بجدول مواعيد ؟
فندق هيلتون بعيد من هانا؟	هل فندق هيلتون بعيد عن هنا ؟
ارفعو ايديكم.	ارفعوا أيديكم .
تنصحونا بطعم قريب من هانا؟	هل يوجد مطعماً يمكنك أن تزكيه بالقرب من هنا ؟
ايش يعجبك، الظلمي او الضوء؟	أيهما تفضل , داكن أم فاتح ؟
ممكن تقل لي لاين عنسافر؟	هل لك أن تخبرني عن مكان تحليق الطائرة الآن ؟
تذكره نقل، لو سمحت.	تذكرة نزول وركوب طائرة أخرى من فضلك .
اين به بقعه حاليه نعمل لها يوم رحله؟	أين يوجد مكان لطيف لقضاء نزهة ليوم واحد ؟
ايحين بيفتح البنك؟	متى يفتح المصرف ؟
بين احس بتعب.	أشعر بالإعياء .
قد انا مربوش. ممكن ترسم لي خريطه؟	سأرتبك . هل تمانع في رسم خريطة لي ؟
ضروري اجي للمستشفى يوميه؟	هل يجب أن آتي إلى المستشفى كل يوم ؟
بطني بتوجعني.	معدتي تؤلمني .
بكم ارسل هذه الرساله لليابان عبر البريد؟	كم أجرة البريد لإرسال هذا الخطاب إلى اليابان ؟
اشتي قلص شيري.	أريد زجاجة من نبيذ شيري الأسباني .
تشتي احد يشل لك من المطار؟	هل تريد أن يأتي أحد ليأخذك من المطار ؟
من اين اقدر اشتري كرت للتلفون؟	من أين يمكنني شراء بطاقة هاتف ؟
اقدر ارجعه ب مدينه ثانيه؟	هل يمكنني إعادتها في مدينة مختلفة ؟
لو سمحت خلي الفنيليه اطول شويه.	من فضلك اجعل الجزء العلوي أطول قليلاً .
لازم تبسر متخصص.	تحتاج لرؤية أخصائي .
طريق رقم اربعطاعش.	مسار رقم أربعة عشر .
اوه، صدق؟ انت اكيد معك قسم كبير.	آه ، عندك ؟ بالتأكيد إن لديك تشكيلة كبيرة .
اشتي نسخه من تقرير السرقه.	أريد نسخة من تقرير السرقة .
ممكن تقل لي لمن تكون هناك؟	هل لك أن تعطيني إشارة بالضوء عندما تكون فيها ؟
ايوة. هكذا بالضبط.	حسنا . مثل هذه فسحب .
اشتي تطول اكمام الجاكت الرياضي.	أود أن أجعل أكمام هذا الجاكت الرياضي طويلة .
معي حجز. هذا رقم التاكيد.	لدي حجز . هذا هو رقم تأكيد الحجز .
عيدميلادك قدو عيجي.	عيد ميلادك اقترب .
هي العمارة الثانية على يسار هذك العمارة البيضاء.	إنه المبنى الثاني على يسار هذا المبني الأبيض .
ماشي، قدام شوية. هاناك، ايوة.	لا . قليلاً في الأمام . هناك ، نعم .
ايوة، هذاك ما يشملش الوجبات.	نعم ، هذا لا يشمل الوجبات .
فين اقدر ارجع تيه التذكرة؟	أين يمكنني استعادة ثمن هذه التذكرة ؟
ليش بيحصل؟	لماذا يحدث هذا ؟
اشتي ارتاح.	أريد أن أحصل على استراحة .
اشتي يوقع شعري اطول شوية من ورا.	أريد أن يكون شعري خلف رأسي أطول قليلاً .
ايش معاكم من انواع؟	ما هي الأنواع التي لديكم ؟
ايش براسك من موديل؟	ما هو نوع النموذج الذي تفكر فيه ؟
تقدر لوسمحت ترسم لي خريطة مبسطة من هانا؟	من فضلك ، هل رسمت لي خريطة بسيطة من هنا ؟
وين نلتقي؟	أين نتقابل ؟
اشتي يتصلح شعري مثل ما كان.	أود تصفيف شعري بالطريقة التي كان عليها من قبل .
هاتلي خمسين لوسمحت.	أعطني خمسين ، من فضلك .
وين اقدر اسجل دخولي للخطوط الجوية اليابانية؟	أين يمكنني أن أقوم بإجراءات الدخول للخطوط الجوية اليابانية ؟
هل به اماكن في المنطقة ينصحوا بها بشدة؟	هل هناك أي أماكن في المنطقة تلقي تزكية كثيرة ؟
هاتلي فكة لوسمحت.	من فضلك أعطني بعض الفكة .
طيب. شاتأكد انو حقك الشنط يوقعين هانا.	حسناً . سأتأكد أن حقائبك ستكون هنا .
هذا هو تخصصنا، دوفر سول مشوي.	هذا هو طبقنا المميز , سمك موسى المشوي الخاص بدوفر .
عنجلس.	سنمكث .
قد استرقت.	لقد تعرضت لعملية سلب .
تمام. لازم اركزعليه؟	حسناً . هل يجب أن أقوم بتركيزها ؟
مابش معانا هذا الموديل بالصبط الان. شابسر المخزن. راعي شوية لوسمحت.	لا يوجد لدينا نفس الطراز الآن . سأفحص مخزوننا . انتظر دقيقة من فضلك .
سكوتش مع ماء، لوسمحت.	ويسكي اسكتلندي وماء من فضلك .
شكله حالي. كم يكلف؟	هذا يبدو رائعاً . ما الثمن ؟
شل هذه الوصفة للصيدلية. تقدر تشل العلاج من هاناك.	خذ هذه التذكرة الطبية إلى الصيدلية . يمكنك الحصول على الدواء من هناك .
انا طلبت هذاك.	لقد طلبت ذلك .
ايوة، تقدرتوقف في اي محطة بين هانا وشيكاجو.	نعم , يمكنك أن تتوقف في أي محطة ما بين هنا وشيكاغو .
وين اقدر اشتري تذكارات؟	من أين يمكنني شراء بعض الهدايا التذكارية ؟
هو غالي قوي. مقدرش اشتريه.	إنها غالية الثمن . لا أستطيع شرائها .
كيف تشتي حقك البيض؟	كيف تحب أن تأكل البيض ؟
هو جنب هذا المبنى بالضبط.	يوجد بجانب هذا المبني تحديداً .
ماشي، شكلهم نسيوا يدوا لنا واحد.	لا , أعتقد أنهم نسوا أن يحضروا واحدة لنا .
تمام، قدو مأكد. نقدر نشل رقم تلفونك، احتياط لو احتجنا نتواصل معك؟	حسناً . لقد تم التأكيد . هل يمكننا أن نأخذ رقم تليفونك في حالة الحاجة إلى الاتصال بك ؟
ايش اسم المرنج؟	ما هو اسم الرسام ؟
اخليه يرجع يتصل بك لما يجي؟	هل أجعله يعاود الاتصال بك عندما يعود ؟
اشتي اشل هذاك.	أود أن آخذ هذا .
تعجبني هذه الخدمة حق الترحيب بالشامبانيا بعد ما نطلع. خلينا نشرب في صحتك.	أحب هذه الخدمة بتقديم شامبانيا للتحية بعد الإقلاع . دعني أشرب فى صحتك .
اربعين دولار باليوم زايد ثمانية سنت بالميل.	أربعون دولار يومياً ، بالإضافة إلى ثمانية سنت لكل ميل .
شاراهنك بخمسة دولار.	أراهن بخمسة دولارات .
مشو هذا طلب احد ثاني؟	هل هذا طلب شخص آخر .
تقدر تقولي كيف اوصل للمتحف؟	هل قلت لي كيف أذهب إلى المتحف ؟
انا اسف قوي، بس انا اشتي ااجل الموعد.	آسف جدا ، لكني أود تأجيل الميعاد .
القطارحقك عيخطى من المنصة الثامنة.	سيغادر قطارك من الرصيف رقم ثمانية .
بين ادور شنطة بحزام قابل للتعديل.	أبحث عن شنطة بحزام متحرك .
اشتي اجلس تحت مية وثمانين دولار.	أود أن تبقي تحت مائة وثمانين دولار .
تقدر توريني ثانيات بموديلات ثانية مختلفة؟	هل يمكنك أن ترني أشياء أخري ذات تصميمات مختلفة .
ايش من نوع عصير تشتي؟	ما نوع العصير الذي تفضله ؟
عتروح بلدك في الاجازة؟	هل ستعود لبلادك في الاجازات ؟
اشتي ارسل هذا بالبريد الجوي لليابان.	أود أن أرسل ذلك إلى اليابان بالبريد الجوي .
يوم الشكر للعمال. هو يوم شكر لكل هذولا الي بيدعموا المجتمع باشغالهم.	عيد الشكر والعمال ، فهو يوم الشكر لكل الذين ساندوا المجتمع بأعمالهم .
ممكن شوية شاهي زيادة، لوسمحت؟	هل يمكنني أن أحصل علي مزيد من الشاي ، من فضلك ؟
اشتي هذولا الملابس نظيفات لا بعدين.	أريد أن أغسل ملابسي في وقت لاحق اليوم .
به بنك بقريب من هانا؟	هل يوجد بنك بالقرب من هنا ؟
ممكن تنظف الطاولة، لوسمحت؟	هل من الممكن أن تنظف المنضدة من فضلك ؟
لوسمحت اكتب رقم غرفتك ورا.	من فضلك ، اكتب رقم الغرفة في الخلف .
احنا نستخدم عيدان اكل صينية لمن ناكل.	نستخدم الأعواد عندما نأكل .
ديلتا الرحلة رقم ثمانية وعشرين الى نيو اورلينز عتتاخر تقريبا ساعة واحدة.	رحلة الطيران دلتا رقم ثمانية وعشرون والمتجهة إلي نيو أورلينز سوف تتأخر حوالي ساعة .
لما ارجع لليابان، شاكتب رسالة. لو معك وقت لوسمحت رسل لي رسالة.	عندما أعود ثانية إلى اليابان ، سأكتب خطاباً . وإذا كان لديك وقت ، من فضلك أرسل لي خطاباً .
فلتت تذكرة الطيارة حقي في الفندق.	نسيت تذكرة الطيران الخاصة بي في الفندق .
شكرا مرة ثانية لانك ذكرتني. هل ناس خيرات ينسوا يوقعوا؟	أشكرك ثانية لأنك ذكرتني . هل يميل كثير من الناس أن ينسوا توقيع أسمائهم ؟
طيب، الوقت بيكمل علينا. نقدر نكمل هذا النقاش يوم الخميس الساعة واحدة؟	حسناً . ليس لدينا وقت . هل يمكن أن نكمل هذه المناقشة يوم الخميس في الساعة الواحدة ؟
طيب. شاتصل بك لما يجهزين.	حسناً . سأتصل بك عندما يكونوا جاهزين .
مارايك نتغدى؟	ماذا عن الغداء ؟
لاي ساعة اقدر استخدم مطعم الفندق؟	إلى متي يظل مطعم الفندق متاحا للاستخدام من قبلي ؟
ممكن اخذ علاج لوجع معدتي؟	هل لي أن أتناول بعض الدواء لآلام في معدتي ؟
اشتي دجاجة مشوية.	أود أن أتناول فراخ مشوية .
هو غلطي. مشو غلطك.	إنه خطئي . ليس خطأك .
هذاك لوسمحت.	هذا , من فضلك .
لحظة بس، لوسمحت. شاوصلك بمستر جونز.	لحظة فقط , من فضلك . سأوصلك بالسيد جونز .
اهلا. هذه شركة طيران يونايتد.	مرحبا . هذه هي الخطوط الجوية المتحدة .
تقدر تضيق هذا البنطلون؟	هل يمكنك ترتيب هذه البناطيل ؟
الجمعة الليل، الساعة تسعة.	مساء الجمعة , في التاسعة .
هل هذه البوابة لا لاس فيغاس؟	هل هذه هي البوابة إلي لاس فيجاس ؟
معك باص من المطار؟	هل لديك أتوبيس من المطار ؟
ملعقة ثانية، لوسمحت.	ملعقة أخرى , من فضلك .
هو مالح شوية، بس عجبني. اديته معك من اليابان؟	إنها مالحة قليلا , لكنني أحبها . هل أحضرتها معك طوال الطريق من اليابان ؟
لوسمحت استعجله، اذا ممكن.	قم بدفعها من فضلك , إن كان ذلك ممكنا .
تقدر تدفع عشرة دولار هانا كعربون؟	هل من الممكن أن تدفع مبلغ عشرة دولارات للمقدم ؟
ايوة. قومني بعد ثلاث ساعات، لوسمحت.	نعم . أيقظني من النوم بعد ثلاثة ساعات , من فضلك .
ملعقتين، لوسمحت.	ملعقتين , من فضلك .
ايش المحطة الجاية؟	ما هي المحطة القادمة ؟
معك علاج لمعدة وجيعة؟	هل تناولت دواء لتقلبات المعدة ؟
هل لازم البس كوت وكرفتة؟	هل أحتاج إلى أن أرتدي معطف و رابطة عنق ؟
نسيت شنطة اليد حقي.	لقد نسيت أن آخذ حقيبتي اليدوية .
ساعتي. هي كانت جديدة سويسرية رقمية.	ساعتي . لقد كانت ساعة رقمية ماركة حديثة سويسرية الصنع .
اقدر اسير اتفرج على معالم سياحية والسفينة في الميناء؟	هل يمكن أن أذهب لمشاهدة المعالم أثناء رسو السفينة في الميناء ؟
احسن لك تعدل المراية الخلفية.	من الأفضل أن تضبط المرآة العاكسة للرؤية الخلفية .
اعتقد اننا فلت حقي الكاميرا لما تعشيت هانا امس.	أعتقد أنني تركت كاميرتي وغادرت عندما كنت أتناول العشاء هنا الليلة الماضية .
شلهن عند البوابة.	اجمعهم عند البوابة .
ها، ماشي. مشو ضروري. اقدر اهتم بالموضوع. قد عملت كفاية وزيادة.	أوه ، لا . لن يكون هذا ضرورياً . أستطيع أن اعتني به . لقد قمت بالفعل بما هو اكثر من كاف .
يا اما تصلحه ولا تبدله، لوسمحت.	إما أن تصلحها أو تستبدلها ، من فضلك .
اقدر اعمله اي وقت الشهر الجاي.	يمكنني القيام بها في وقتا ما الشهر القادم .
كيف يقارن هذا المنتج الجديد بالمنتجات الموجودة؟	كيف يتم مقارنة هذا المنتج الجديد مع المنتجات الموجودة ؟
ممكن تخلي هذا لي؟	هلا احتفظت بهذا لي ؟
معك العلامات حق الاستلام حقك؟	هل لديك بطاقات ادعائك ؟
اشتي استخدم سياره لمده اسبوع.	أرغب في تأجير سيارة لمدة أسبوع .
من الصبح.	منذ هذا الصباح .
احسن لو نسرع. قد هم بيطلعوا من الان.	من الأفضل أن نسرع . انهم يركبون بالفعل .
طلبت دجاج.	طلبت دجاجا .
لعشر ايام.	لمدة عشرة أيام .
كم عمر هذا الولد؟	كم عمر هذا الصبي ؟
بكم هو كله؟	كم التكلفة كلها ؟
اشتي نفس هذاك، لو سمحت.	أريد نفس الشيء ، من فضلك .
ضيعت شيكي السياحي.	لقد فقدت شيكاتي السياحية .
لو سمحت جيب لي علاج للبرد.	من فضلك أعطني دواء للبرد .
لو سمحت اطرحهن في كون.	من فضلك ضعها في قمع .
انا دايما ابسره كل صباح بالقطار.	أراه دائما كل صباح في القطار .
ممكن تتعشى معانا في الليل؟	هل تستطيع أن تتناول العشاء معنا هذا المساء ؟
شا اجلس في فندق بي لبكره. شا اكون فرح لو تقل له ان انا هانا.	سأقيم في فندق بي حتى غداً . أكون مسروراً إذا أخبرته أنني هنا .
انا اسمي شينو يامادا.	اسمى شينو يامادا .
ايش تخصص هذا المطعم؟	ما هو تخصص هذا المطعم ؟
علاج برد بس.	فقط دواء للبرد .
اوة، شكلي دايما اضيع حاجه كل مره اسافر.	أوه ، يبدو أنني افقد شيء ما كل وقت أسافر فيه .
ان فقدت استخدام ايدي اليمين.	فقدت استخدام الذراع الأيمن .
مرحبا، هذا روي؟	هالو ، هل هذه تعود إلى روي ؟
لا، مش هانا. به غرفه للمشقرين خلف هذه العربة.	لا ، ليس هنا . هناك حجرة تدخين قرب مؤخرة هذه الحافلة .
ممكن بروشور؟	هل لي بدليل سياحي ؟
اوصل هاناك على تسع، لو سمحت.	كن هناك بحلول التاسعة ، من فضلك .
ايوة، سيدي. كيف تشتيني اقصه لك؟	نعم ، سيدي . كيف تريدني أن اقطعها ؟
بس زيت وخل وعيكون تمام.	زيت و خل فقط سيكون جيداَ .
انا لقيت بالضبط اللي كنت تشتيه. اقدر اقترح هذا؟	لقد فهمت ما أردت أنت بالضبط . هل لي أن اقترح ذلك ؟
كيف أوصل لا ديزني لاند؟	كيف يمكنني الذهاب إلى ديزني لاند ؟
هل تعتقد؟	أتظن ذلك ؟
عفوا، اين المطعم الرئيسي؟	معذرة . أين المطعم الرئيسي ؟
اشتي افعل اتصال ل اليابان.	أريد الاتصال هاتفياً باليابان .
ايش من نوع معك في راسك؟	ما النمط الذي في مخيلتك ؟
ايوه. عنوصل على ثمان بالتوقيت المحلي.	أجل . سنصل في الثامنة حسب التوقيت المحلي .
ممكن تدي لي لحم خنزير وبيض؟	هل لي في شيء من لحم الخنزير والبيض ؟
عصير شمام نحلي، لو سمحت.	شراب الشمام كحلاء ، من فضلك .
الماء الحامي مشو حامي كفايه.	المياه الساخنة ليست ساخنة بالقدر الكافي .
ممكن تشرح كيف تفعل هذا؟	هل يمكنك توضيح كيفية عمل ذلك ؟
شكرا. ارجع لا غرفتي في نفس الوقت بكرة. عيكونين الصور جاهزات لا هذاك الساع.	شكراً . عد إلى غرفتي في نفس الوقت غدا . ستكون الصور جاهزة . قبل ذلك .
انا اسف الان تقدر بس تطلب من المنيو حق الليل.	آسف فالآن لا يمكنك الطلب سوى من قائمة الطعام الليلية .
عادي والا منقى؟	برصاص أم بدون رصاص ؟
فيني صداع.	أشعر بصداع .
ليحين الفيزا هذه صالحه؟	كم مدة صلاحية هذه الفيزا ؟
به مستشفى هانا قريب؟	هل ثمة مستشفى قريب من هنا ؟
اشتي بدله.	أريد بزة .
معك عرض اكبر؟	ألديك مقاس أوسع ؟
به اكبر من هذلا؟	هل لديك أحجام أكبر ؟
يعتمد على كيف المكان دافي، لكن في وسط اليابان، بدايه ابريل.	يتوقف الأمر على درجة حرارة المكان . ولكن في وسط اليابان , في أوائل أبريل .
برجر بالجبنه مع شبس.	أريد سندويتش برجر بالجبن ومقليات .
قدوة متاخر قوي للقطار الاخير.	لقد بالغ آخر قطار في التأخر .
مابش عندي فكه.	ليس معي فكة صغيرة .
شليت تذكره الباص حقك؟	هل أخذت تذكرة الحافلة ؟
رصيد، لو سمحت.	البطاقة الائتمانية ، من فضلك .
كنت في رحله طيران يونايتد ثمانيه اثنين ثمانيه.	كنت على رحلة يونيتد إيرلاينز رقم ثمانية اثنان ثمانية .
قوي ازعاج جمب غرفتي.	إن حول غرفتي ضجيجا بالغا .
معك اوراق يابانيه؟	هل لديك صحف يابانية ؟
فكره سابره.	هذا طيب ، على ما يبدو .
عادي لو اخلي شنطتي معك للساعه واحده؟	هل تمانع في أن أترك حقائبي معك حتى الساعة الواحدة ؟
به رحله للمدينه؟	هل ثمة رحلة في المدينة ؟
ايوة، أسف مضطر. كيف الامن متمكن في هذه المنطقه؟	أجل . أخشى أني مضطر لذلك . ما مدى حفظ الأمن في هذه المنطقة ؟
جهه المدخنين، لو سمحت. ومقعد على الطاقه، لو سمحت.	ركن المدخنين ، من فضلك . وشباك بجوار النافذة ، من فضلك .
وكم بتشل على الخياطه؟	كم تتقاضى نظير التفصيل ؟
معك هذا التيشرت ب الوان ثانيه؟	هل لديك ألوان أخرى لهذا التي شيرت ؟
ايوة، احنا جايين عليه، جايين عليه.	أجل ، إننا على وشك معالجته ، على وشك معالجته .
كان احسن لو دخلت حقنا المستشفى.	من الأفضل لك أن تدخل مستشفانا .
كم باقي نقط لوما اغير؟	كم محطة قبل التحويل ؟
هذا الرجال سرق محفظتي.	لقد سرق ذلك الرجل كيس نقودي .
حبوب الهضم وحبوب وجع البطن ثانيات، صح؟	حبوب عسر الهضم تختلف عن حبوب ألم المعدة ، أليس كذلك ؟
كم ياخذ وقت بالمشي؟	كم تستغرق مشياً على الأقدام ؟
هو سهل. انا بس شابسر في دفتر التلفون.	الأمر يسير . سأنظر في دليل الهاتف فحسب .
كم هي حقي الفاتورة؟	كم فاتورة الحساب ؟
عفوا، لكن اشتي اسلم تقرير السرقه.	معذرة . ولكني أريد تسليم تقرير السرقة .
طيب، يعتمد على نوع المواصلات اللي عتاخذ. عتسير بالباص ولا بالطايره؟	حسنا ، الأمر يتوقف على وسيلة المواصلات التي تأخذها . هل ستذهب بالحافلة أم الطائرة ؟
عندك مانع لو اجلس هانا؟	هل تمانع في جلوسي هنا ؟
ممكن ارسل بس إيميل واحد بدولار؟	هل يمكنني أن أرسل أي ميل واحد فقط قيمته دولار .
ايوة، لو سمحت ارسله لغرفه اثناعش اربعه-وثلاثين.	أجل ، من فضلك أرسله إلى الغرفة اثنا عشر أربعة وثلاثون .
ايحين المفروض اجي المطار؟	متى يتعين على الوصول إلى المطار ؟
أسف الحمام مايشتغلش. احتاج مساعدة.	آسف الحمام به عطل . أحتاج للمساعدة .
شا اشلك لا مقعدك. من هانا، لوسمحت.	سأذهب بك على مقعدك . من هنا ، من فضلك .
اسمحلي، ممكن اسألك سؤال؟	معذرة ، هل يسعني أن أتوجه إليك بسؤال ؟
اعتقد هذا والكل.	أعتقد ذلك .
اشتي اشيك هذولا الشنط لا طوكيو، لوسمحت.	أريد فحص هذه الحقائب المتجه إلى طوكيو , من فضلك .
ممكن توريني واحدة اكبر شوية؟	هل يمكنك أن تريني حجماً أكبر بقليل ؟
اعتقد الملابس المصنوعه باليابان خياطهن احسن.	أظن أن الملابس المصنوعة في اليابان قد جرى تفصيلها على نحو أفضل بالتأكيد .
لو كنت استسلمت احسن.	الأجدر بك أن تكف عن ذلك .
ممكن تكتب لي رقم التلفون والعنوان، لوسمحت؟	هل يمكنك تسجيل العنوان ورقم الهاتف من أجلي ، من فضلك ؟
هو حامي؟	هل بها جهاز تدفئة ؟
من أي مطار شاسير؟	من أي المطارات سأغادر ؟
شليت النموذج في الطائرة؟	ألم تتلق الاستمارة بالطائرة ؟
شكرا لأنك شاركتنا افكارك المميزة.	شكراً على إدلائك بأفكارك الفريدة معنا .
هو هذا الباص الصح لاوسط المدينة؟	أهذه هي الحافلة التي توصل إلى وسط المدينة ؟
بكمو هذا العطر؟	بكم هذا العطر ؟
لأيش هو؟	ما الغرض منها ؟
وين اقدر انجز الاجراءات الرسمية؟	أين يمكنني أداء الإجراءات الرسمية ؟
كيف عيجي؟	كيف تسير الأمور ؟
"يوم الدستور او ""كيمبو كينيبي"" عطلة رسميه يوم ثلاثه مايو للاحتفال بإنشاء الدستور الياباني الحالي."	"عيد الدستور أو "" كيمبو كينينبي "" عطلة قومية في الثالث من مايو للاحتفال بذكرى وضع الدستور الياباني الحالي ."
هذه الرحلة بتتضمن زيارة لا برج سيرز؟	هل تشمل هذه الرحلة زيارة لبرج سيرز ؟
به محل كتب هانا؟	هل ثمة محل قريب لبيع الكتب ؟
منين بنخطى ذاحين؟	ما هذا المكان الذي نمر به الآن ؟
اثنين كبار وجاهل عمرة ثلاث سنين.	اثنان كبار وطفل عمره ثلاث سنوات .
في حمام في المحطة.	في غرفة انتظار بالمحطة .
