هو هناك، بالظبط أمام مكتب معلومات السياح.	هناك ، أمام بيانات السائح تماما .
ما حصل سمعت بالعنوان دا هنا.	لم اسمع بهذا العنوان من قبل بالقرب من هنا .
أمشي دغري لغاية تشوف صيدلية.	استمر في السير في هذا الطريق حتى تجد صيدلية .
بي كم الفطور؟	كم تكلفة الإفطار ؟
كيف ممكن اساعدك؟	كيف أستطيع مساعدتك ؟
أمشي شمال عند الكورنة التالتة.	اتجه يسارا عند الناصية الثالثة .
داير كريمة و سكر في قهوتك؟	هل تحب أن تضع قشدة وسكر في قهوتك ؟
هل يمكنك تصرف شيكي البي متين دولار؟	هل يمكنكم صرف الشيك ذو المائتي دولار الخاص بي ؟
اذا مفروض يظهر، من فضلك اتصل على.	إذا حدث ذلك ، من فضلك أتصل بي .
وين المقهى؟	أين المقهى ؟
داير بلوفر أطفال.	أريد جاكيت للأطفال .
ح أواجه أي صعوبات مع الجمارك؟	هل لديك أحذية حريمي عند أصابع القدم ؟
هل عندك جزمة رسمي عريضة عند اصابع القدم؟	هل ستواجهني أية صعوبات في الجمارك ؟
لا. ممكن اقترح غرفة مزدوجة لاستعمال شخص؟ عندنا واحدة.	لا ، هل لي أن أقترح أخذ غرفة ذات سريرين للاستخدام الفردي ؟ فنحن لدينا واحدة .
داير تجعيدة ضيقة، من فضلك.	أريد تمويج متقارب لشعري ، من فضلك .
دايرة بيرة.	هي تريد بيرة .
صباح الخير. كيفك؟	صباح الخير . كيف حالك .
آسف ح احتاج اشوف اثبات هوية.	أسف أنني بحاجة إلى أن أطلع على أي مستند لتحديد الهوية .
ياتو نوع من الصوص؟	أي نوع من الملابس ؟
دا بارد شوية. ممكن تسخنه؟	هذا بارد إلى حد ما . هل يمكن أن تقوم بتسخينه ؟
انا تمام. بس ممكن تتصل ب صحبى؟	أنا بحالة جدية ، لكن هل تمانع في الاتصال بصديق ؟
منو صحبك المفضل؟	من هو أفضل صديق لك ؟
هل انت دايرني اتحقق تحت غطا العربية؟	هل تريد أن افحص موتور السيارة ؟
هل ممكن تساعدني ألقى شنطتي؟	هل لك أن تساعدني في الوصول إلى حقيبتي ؟
هل ممكن تعمل ترتيبات مقدما؟	هل ستقوم بعمل الترتيبات مقدماً ؟
في زول بيساعدني. شكرا ليك.	تقدم إلىّ المساعدة ، شكراً لك .
لمن تصل هناك، اسأل زول تاني، من فضلك.	عندما تصل هناك أسأل شخص آخر ، من فضلك .
هامبرقر واحد و واحد بيرقر بالجبنة، من فضلك.	واحد هامبرجر وواحد شيز برجر ، من فضلك .
كم من السعر بتطلب للعملية؟	كم تتقاضى لتطبيع صور الفيلم ؟
الموقع كان في كرسي في اللوبي.	المكان كان على كرسي في البهو .
داير دكشنري مقاس جيب، من فضلك.	أريد قاموس جيب ، من فضلك .
لنفرين عند السابعة. الاسم واتانيبل.	لشخصين عند الساعة السابعة , الاسم وتاناب .
ساعتي. كانت سيكو ديجيتال.	ساعتي . كانت ساعة سيكو رقمية .
ح يكون متعتنا ان نخدمك بمشروب من اختيارك، مصحوب بي عشاء. دليل كامل من المشروبات البنوفرها في الرحلة دي موجودة في دليل المعلومة بتاع مجلتنا.	يسعدنا أن نقدم لك الشراب الذي تريده متبوعاً بالغداء . دليل كامل بالمشروبات التي نقدمها على رحلتنا موجودة في دليل المعلومات الخاص بمجلتنا .
معظم اليابانيين بياكلوا اخطبوط و حبار.	معظم اليابانيين يأكلون الأخطبوط والحبار .
ممكن اخد تذكرين درجة تانية الي شيكاغو، من فضلك؟	هل يمكنني الحصول على تذكرتين درجة ثانية لشيكاغوا , من فضلك ؟
مشيت نيويورك.	لقد ذهبت إلى نيويورك .
رقم الرحلة كم؟	ما هو رقم الرحلة الجوية ؟
دا مكتب الاستقبال؟ في عيادة قريبة؟	هل هذا مكتب الاستقبال ؟ هل يوجد عيادة قريبة ؟
هل عشرة دولارات كفاية للتكسي؟	هل عشرة دولارات ستكون كافية للذهب بالتاكسي ؟
أي. انتظر، بجيب ليك واحد.	نعم . انتظر , سوف احضر لك واحدة .
ما حقيقة. بس حاجة ما غالية.	ليس تماماً . فقط شيء ما غير غالي الثمن .
بتفتش لحاجة؟	هل تبحث عن شيء ما ؟
أربعة ليالي.	أربع ليالي .
ممكن تخليه ارخص لان هناك بعض البقع؟	هل تستطيع أن تخفض سعرها لوجود بعض البقع بها ؟
رجل صدمني. بعد داك لاحظت ان محفظتي ذهبت.	ارتطم بي شخص وبعد ذلك اكتشفت أن محفظتي قد سرقت .
انا ما متأكد اذا حزمت ملابس كافية لي رحلة تلاته اسابيع.	أنا غير متأكد إذا كنت قد حزمت ملابس كافية لرحلة مدتها ثلاثة أيام .
طيب، دايرين نجرب خمرة بيضاء.	حسناً ، أود أن أجرب النبيذ الأبيض .
اذا في زول سأل عني، كلمهم اني في المقهى.	إذا سأل أحد عني فأخبره بأني سوف أكون بالمقهى .
متأكد أنه عندي في الجيب الداخلي بتاع الجاكيت بتاعي.	أنا متأكد أني وضعتها بالجيب الداخلي للمعطف .
هل الخطوط الجوية ح تدفع لي عشان اشتري بعض الضروريات الشخصية؟	هل ستدفع لي شركة الطيران لشراء بعض الاحتياجات الشخصية الأساسية ؟
الخطوط الجوية اليابانية، رحلة رقم واحد اتنين تلاتة.	شركة الخطوط الجوية اليابانية ، طائرة رقم واحد اثنان ثلاثة .
محتاج اشتري شامبوه.	أرغب في شراء شامبو .
ممكن تكلمني لم نصل الي مركز مدني؟	هل بإمكانك أن تخبرين متى نصل إلى مجمع الخدمات العامة .
وين أقرب جزار؟	ـ أين أقرب محل جزارة ؟
دايرين نقعد أربعة ليالي من الأول من أغسطس.	نرغب في أن نقيم أربع ليالي بدءاً من أول أغسطس .
اسم الزهرة ديك شنو؟	ما اسم هذه الوردة ؟
خمستشار سبتمبر هو يوم احترام للمسنين.	الخامس عشر من سبتمبر يوم احترام المسنين .
ما في صابون في غرفتي.	ليس هناك صابون في حجرتي .
هل يمكنك تغير الصيغة الي القلته الان؟	هل يمكنك أن تغير الصياغة طبقاً لما قلته للتو ؟
ممكن تتكلم أعلى شوية، من فضلك؟	لا أستطيع أن أفعل ذلك , لكني سوف أضعها في الحقيبة لك .
كم من الزمن ح يكون قبل يطلع؟	كم تستغرق حتى تصبح متاحة .
وين معلومات الرياضات؟	أين الاستعلامات الرياضية ؟
المقاس دا هنا، الواحد المسميه مقاس منتظم، ح يعمل.	هذا المقاس ، الذي تسميه المقاس العادي ، سوف تجده هنا .
وين مفترض اغير القطار عشان اوصل ادينبيره؟	من أي مكان يمكنني أن أغير القطار الذي يوصلني إلى إدنبره ؟
داير اخت دا في صندوق ايداع امن.	أود أن أضع ذلك في صندوق ودائع آمن .
وين ممكن أبدل قروش؟	أين يمكنني تغير نقودي ؟
محتار الرسوم دي في تلفوني لي شنو.	أتساءل عن هذه الرسوم الزائدة على فاتورتي .
ح ادفع خمسين دولار.	أنا سوف أدفع خمسون دولاراً .
الآن عرفت الكان غلط شنو.	الآن أعرف . ماذا كان الخطأ . ؟
بس سياحة.	فقط سياحة .
تمام. من فضلك وقعهم. دايرو كيف؟	هذا جيد , من فضلك وقع عليهم . كيف تريدها ؟
داير واحد كبير.	أود الحصول على واحدة كبيرة .
انا مصور حر.	أنا مصور حر .
التجار ممكن يحاولوا دولاراتك إلى قطع الكازينو؟	يستطيع الصرافون أن يغيروا دولاراتك من أجل بقشيش الكازينو . هل نذهب ؟
ح يكون عندي ليك الاقتراح الأسبوع الجاي.	سوف أحضر لك العرض الأسبوع القادم .
شكرا ليك. كم سعر القفازات دي؟	شكراُ لك . كم تكلفة هذا القفاز ؟
على أن أمشي. ح اتصل بيك لاحقا.	علىّ أن أذهب ، سأتصل بك لاحقاً .
داير بعض الحفاظات الممكن التخلص منها.	أريد بعض الحفاضات التى يمكن التخلص منها بعد الاستعمال .
ح تحولهم لي دولارات، من فضلك؟	هل لك أن تغيرهم إلى دولارات من فضلك ؟
بفضل غرفة هادية.	أُفضلُ حجرة هادئة .
در بعض مزيل طلاء الأظافر.	أريد مزيلا لطلاء الأظافر .
داير بطارية.	أريد بطارية .
هل يمكنني تأجير بعض معدات الغطس؟	هل أستطيع تأجير أداة للتنفس أثناء السباحة ؟
هل هذه الحقيبة مثالية لكل طقس؟	هل هذه الحقيبة مناسبة لكل حالات الطقس ؟
داير دونات، من فضلك.	أريد كعكة محلاة من فضلك .
داير أأجر عربية اوتوماتيك ليومين.	أريد تأجير سلاح آلى لمدة يومين .
فوت الرحلة عشرين إلى سان فرانسيسكو.	لم أدرك الرحلة رقم عشرون المتجهة إلى سان فرانسيسكو .
داك جيد. متين؟	هذا جيد . متى هو ؟
كم عمر بنتك؟	كم عمر ابنتك ؟
ممكن تكلمني ببعض الفنادق الرخيصة و النضيفة؟	هل يمكن أن تدلني على بعض الفنادق الرخيصة والنظيفة ؟
ممكن نحجز ليك غرفة مريحة في قصر قديم قرب نادي قولف مشهور.	يمكننا ان نحجز لك غرفة مريحة في قلعة قديمة بالقرب من نادي جولف شهير .
تزكرتين درجة ثانية، من فضلك.	تذكرتين درجة ثانية من فضلك .
ممكن أقدم ليك أي حاجة؟	أيمكنني أن أقدم لك أي شيء ؟
يومي؟ خايف اسأل، لكن قصدك شنو؟	أخشى أن أسأل ، لكن ماذا تعني ؟
داير واحد داك ال ح يحفظ ملفات مقاس ورقة رسالة عادية بدون طيهم.	أريد الشخص الذي يعد وثائق عادية في حجم ورقة الخطاب بدون الحاجة إلى طيهم .
اناحساس للقطط.	أنا شديد الحساسية للقطط .
اي، مفروض تملك رخصة قيادة و، اه، انت مفروض يكون عندك رخصة من لجنة التكسي و الليموزين.	نعم , لا بد أن يكون عندك رخصة قيادة ، ولا بد أن تحصل على رخصة من لجنة التاكسي والليموزين .
واصل، يا سيدي.	استمر يا سيدي .
داير احجز غرفة لليلة.	أود أن أحجز غرفة لهذه الليلة .
لا، استبعد الضرائب و مصاريف الخدمة.	لا ، إنها لا تشمل الضريبة ومصاريف الخدمة .
الآن، مكالمتك اتقبلت . من فضلك اتفضل.	الآن ، مكالمتك ردت . تفضل من فضلك .
كم رقم البوابة؟	ما رقم البوابة ؟
شنو مطابق تزكار هاوايوان؟	ما التذكار الخاص بهاواي ؟
ممكن اصل هناك بالنفق؟	أيمكنني أن أذهب هناك بمترو الأنفاق ؟
بالتأكيد. خليني أشوفه. انت اتجرحت بالمهرجان، افترض.	بالتأكيد . دعني أراها . أظن أن المرجان جرحك .
احتياط، خليني اخد رقم الزول المسؤول.	لقط للتأكيد ، إعطني رقم المسئول .
هل هناك طريق سريع؟	هل هناك طريق حر ؟
لي ما جاء الحفلة امبارح؟	لماذا لم يأت إلى الحفلة أمس ؟
هناك كان في حادث مروري.	لقد كان هناك حادث مرور .
سوري، عندي الرقم الغلط.	آسف , لقد اتصلت بالرقم الخطأ .
واحد بيرقر جبنة و عصير برتقال، من فضلك.	واحد هامبورجر بالجبن و عصير برتقال , من فضلك .
ممكن اخد الكروية للموسيقى الجمعة الجاية؟	هل أستطيع أن الحصول علي تذكرتان للمسرحية الغنائية الجمعة القادمة .
راكب تاني هناك قال يمكنهم يبدلوا المقاعد معاك.	راكب آخر هناك قال انهم يستطيعون أن يبدلوا مقاعدهم معك .
قول. بتعرف أي حاجة بتستحق النظر قريب هنا؟	يا صاح , أتعرف أي مكان يستحق الرؤية قريبا من هنا ؟
ممكن توريني لم الشنطة الرايحة تتلقى؟	هل من الممكن أن تخبرني عندما تعقروا علي الحقيبة الضائعة ؟
شنو اسم الحديقة القومية دي؟	ما اسم هذه المحمية ؟
عندي جرح.	أصبت بسحجة .
ممكن اتغدا الآن؟	هل أستطيع تناول غذائي الآن ؟
محتاج أبدل الدولارات دي.	أريد أن أستبدل تلك الدولارات .
انا محتاج لتاكسي. انا في ساوث مين و لايبرتي.	أحتاج إلى تاكسي . أنا في ساوث ماين ، وليبرتي .
هو ما تفاح لكن خوخ.	هذه ليست تفاحة ولكنها خوخة .
ح اديك وصفة طبية. شيلا للصيدلية.	سوف أعطيك روشتة . خذها إلى الصيدلية .
أيوة. عندنا داك. ح نجهزوا ليك.	نعم لدينا هذا ، سوف نجهزها لك .
لا، انا بس داير انزل.	ل , ا أريد فقط الزيارة بدون ميعاد .
عربيتي اتسرقت.	لقد تعطلت سيارتي .
وين ظل العين؟	أين مظلل العيون ؟
دايرين ركن هادئ، لو ممكن.	نريد ركناً هادئاً ، إن أمكن .
هل التكسي دا مجاني؟	هل هذه السيارة الأجرة متاحة ؟
هل دي محطة اكسبريس؟	هل هذه محطة قطار سريع ؟
ياتو زمن مفروض اجي ماري؟	متى ينبغي أن آتي ؟
داير دورق صغير من نبيذ ابيض.	أريد دورقاً صغيراً من الخمر الأبيض .
اه. ممكن اخد وجبتي فيما بعد؟ ما حاسي اني كويس أسى.	آه . هل يمكنني الحصول على وجبتي فيما بعد ؟ أنا أشعر أنني لست على ما يرام الآن .
في الحقيقة، عندي اخبار. انا ح اتزوج.	بالفعل لدي أخبار . أنا سأتزوج .
اي سراويل تانيه؟	بنطلون أخر ؟
في وزل اقتحم غرفتي امبارح بالليل.	اقتحمت غرفتي الليلة الماضية .
وريني السمك الشفته اليوم في الألبوم، من فضلك.	أرني السمكة التي رأيتها اليوم في كتاب الصور ، من فضلك .
شوف التعليمات في علبة الأكل المفرغة من الهواء.	انظر التعليمات على علبة الطعام الفارغة .
داير قروش ورق.	أريد نقوداً ورقية .
م عندك دروس تجريبيه؟	أليس لديك دروس تجريبية ؟
انا من بريطانيا العظمى.	أنا من بريطانيا العظمى .
داير احصل علي إعادة دفع لي ده.	أريد أن أحصل على تعويض لذلك .
هناك في صندوق تلفون قدام البنك داك.	يوجد صندوق للهاتف أمام هذا المصرف .
ح اوصل في التاسع من مارس و أغادر في الرابع عشر.	سأصل في التاسع من مارس وأغادر في الرابع عشر .
داك غالي شويه، م يتعاقد؟	هذا غال قليلاً ، ألا تعتقد ؟
هل انت عندك العقل؟	هل لديك كعب ؟
انت بتتكلم؟	هل تتحدث ؟
المثل لي انا، من فضلك.	الشيء نفسه لي ، من فضلك .
طلبي ما وصل.	طلبي لم يأت .
هناك كتير من الربوع الساخنه.	هناك الكثير من الينابيع الحارة .
من فضلك حول خمسين ألف ين للدولار الأمريكي.	من فضلك غير خمسين آلاف ين إلى دولارات أمريكية .
داك كويس معاي. في الحقيقه داير أدخن.	هذا حسن بالنسبة لي . في الواقع أحب أن أدخن .
داير قزازة خمرة حمرة.	أريد كوباً من الخمر الأحمر .
فقط إذا كان كان حقك، سيدى. ههه-ههه، فقط نكته صغيره.	فقط إذا كانت ملكك ، سيدي . هاها ، مزحة صغيرة .
بالتأكيد . كيف ممكن تندمج؟	بالتأكيد . كيف يمكننا خدمتك ؟
هويه. اوه، صاح. هل باسبورت اوكي؟	تحقيق شخصية . آه ، هل جواز السفر ينفع ؟
ح اشوف إذا في واحد من ديل مناسب.	سأرى ما إذا كان أي منها يناسبني .
داير غلاية.	أريد غلاية .
جبتي لي بعض الجبنه المضفره.	أحضر لي بعض من الجبن المبشور .
ممكن تخليه يرجع لي؟	هل لك أن تطلب منه أن يعاود الاتصال بي ؟
ليه طيب؟	لماذا إذاً ؟
البص هناك.	الحافلة هناك .
داير لفتين من ايزو ميه، فلم ملون، سته وتلاتين صورة، من فضلك.	أريد لفتان من ISO مائة ، فيلم ملون ، ستة وثلاثين لقطة ، من فضلك .
داير اشتري طلبات لعشره كروت بريد لليابان، من فضلك.	أود أن أشتري طوابع لعشرة بطاقات بريدية إلى اليابان ، من فضلك .
هل هناك أي بنوك جمب المحطة؟	هل توجد مصارف بالقرب من المحطة ؟
واحد بيرقر جبنه عشان أمشي من فضلك.	واحد شيزبرجر لكي أذهب ، من فضلك .
أجرى.	أجري .
ممكن تعيرني كيبل تقويه؟	هل يمكن أن تقرضني سلك إمداد ؟
وين ممكن اشتري حصيرة الشاطئ؟	أين يمكنني أن أشتري حصيرة للشاطئ ؟
اديني شوية لحم الخنزير، لكن ما سميكه زي داك.	أعطني قطعة لحم الخنزير هذه ، ولكن ليس بسمك تلك .
نحن جاين عند السابعة.	سنأتي في السابعة .
عندي تسجلاتي اتسرقت، برضه.	عندما أرى الأسعار بهذا الرخص ، يبدو الأمر سخيفاً أن أشتري أي شيء في اليابان .
عندي تسجيلاتي اتسرقت، برضة.	سرقت سجلاتي ، أيضاً .
مخروط ايسكريم الفانيلا من فضلك.	مخروط من الأيس كريم الفانيليا ، من فضلك .
اوافق. مفروض يبقى طبيعي.	أوافق . يجب أن تصبح طبيعية جداً .
عقل الوجوه، عقل الفجوه، ثم قرب الأبواب، من فضلك.	لاحظ الفجوة ، لاحظ الفجوة ، ثم قرب الأبواب ، من فضلك .
ح احتاج ل كردت كارد.	سأحتاج إلى بطاقة ائتمان .
من فضلك اديني تقرير حادث.	من فضلك أعطني تقريراً عن الحادث .
لا، شكرا ليك قبل شوية.	لا ، أشكرك حالياً .
أوكي، من فضلك خليك في الخط. مستر تاكاجيما، سيدة سايتو ما شكلها بترد على المكالمة. دايرني اتصل عليها زمن أطول؟	حسنا ، ابق على الخط . سيد/ ناكاجيما ، الآنسة/ سايتو يبدو أنها لا ترد على المكالمة . هل تريدني أن أتصل عليها فترة أطول ؟
يبدوا ان نادر شديد جدا.	يبدو أنها نادرة جداً .
وين استلام العفش لرحلة سبعة صفر تلاتة؟	أين بيان أمتعة الرحلة سبعة صفر ثلاثة ؟
شي غلط مع قبضتك.	شيء خطأ مع حقيبتك .
هل دا ح يفسد؟	هل هذا سيفسد ؟
لا، شكرا. أنا أحسن ما اشرب زيادة.	لا ، شكراً . من الأفضل أن لا أشرب المزيد .
من فضلك وريني بعض الشوارع سهلة للتسوق.	من فضلك أخبرني عن بعض الشوارع المناسبة للتسوق .
الآن، الدهان دا خاص جدا. عمله تسوروتارو كاتاوكا. هو فنان عالمي معروف.	الآن ، هذه اللوحة خاصة جداً . رسمها تسوروتارو كاتاأوكا . إنه معروف بأنه فنان عالمي .
عندي تقدير عظيم للموسيقى الكلاسيكية.	لدي تقدير كبير للموسيقى الكلاسيكية .
تمام. ما اسم ورقم الطرف التاني، لو سمحت.	حسنا . ما هو اسم شريكك ورقمه ، من فضلك .
اعزرني. طلعني، من فضلك.	عذراً . دعني أخرج ، من فضلك .
ممكن تتصل على اصطاف يتكلم ياباني؟	هل يمكنك أن تستدعي موظفاً يتحدث اليابانية ؟
بنزور قرايبنا غالبا.	نزور أقاربنا كثيراً إلى حد ما .
ميكي هياكاوا. الغرفة دي سبعة صفر اتنين.	ميكي هاياكاوا . هذه غرفة سبعة صفر اثنين .
مفروض اقعد هنا الليلة، ول لا؟ ممكن تساعدني اراجع غرفة فندق؟	علي أن أمكث هنا الليلة ، أليس كذلك ؟ هل يمكنك مساعدتي حجز غرفة بفندق ؟
ممكن توريني السعر للمكالمة دي كم؟	هل يمكنك أن تخبرني بقيمة هذه المكالمة ؟
طيب، ممكن توريها اني اتصلت، من فضلك؟ ح اتصل بيها تاني لاحقا.	حسنا ، هل يمكنك أن تخبرها أنني اتصلت ، من فضلك ؟ سأتصل بها مرة أخرى فيما بعد .
في اي جولة صباحية؟	هل توجد أية جولة صباحية ؟
هل تحول العملات الأجنبية؟	هل تغير عملات أجنبية ؟
وين ممكن اشتري لفة فلم؟	أن يمكنني أن أشتري لفة من الفيلم ؟
دي غرفة مس كاوازو ستاشر حداشر.	هذه السيدة كاوازو في غرفة رقم ستة عشر أحدى عشر .
عفوا.	مرحباً بك .
ياتو المهم ليكم يا يابانيين، يوم رأس السنة ول يوم الكريسماس؟	أيهما أكثر أهمية للشعب الياباني , عيد رأس السنة أم عيد الكريسماس ؟
دقيقة فقط، من فضلك.	لحظة من فضلك .
من امبارح.	منذ أمس .
بيتضمن تأمين ضد التصادم و المسؤولية القانونية.	تشمل تأمين ضد التصادم والدين .
انا بتصل من كشك عام في مايسس.	إنني أتصل من كشك عمومي في ماسي .
هل هناك أي فترة معينة من الفن بتفضل؟	هل توجد أي حقبة معينة للفن تفضلها ؟
أمشي دغري على طول النهر حوالي نص ميل. ح تجي الحديقة.	سر في خط مستقيم على طول النهر حوالي نصف ميل . ستصل للمتنزه .
بفتش عن اقمصة جرى.	أبحث عن قميص للجري .
أفضل ليك تركب قطر تمنية و نص.	من الأفضل أن تستقل قطار الثامنة والنصف .
الان موسم المحار، لذا ح يكونوا كويسين.	الآن موسم جمع المحار ، لذلك سيكونون في حالة جيدة .
داير مع ساعة يد تانية.	أريد ساعة مستعملة .
ح اراجع حوالي الساعة تسعة في المساء.	سأقوم بتسجيل الدخول في تمام الساعة الثامنة مساءاً تقريباً .
انا متأخر. مفروض اكون ماشى.	الوقت يتأخر . يجب أن أرحل .
داير شاي، من فضلك.	أريد شاي من فضلك .
لا، ما في هناك.	كلاً ، لا يوجد .
هل دا آخر استوب؟	هل هذه هي آخر محطة ؟
خلينا نتصل بيه.	لنتصل به .
هل الاسبايسي دا سخن؟	هل هذا المتبل حار ؟
وين ممكن ألقى بص لمعالم المدينة؟	أين يمكنني أن أستقل حافلة لمشاهدة المعالم ؟
نعم، أنا داير أعمل مشاهدة للمدينة.	أجل ، أريد مشاهدة معالم المدينة .
شكرا ليك على ضيافتك.	شكراً على كرم ضيافتك .
ممكن تصحيني الساعة ستة، من فضلك؟	هل لك أن توقظني في تمام السادسة من فضلك ؟
بتكلف كم لي نص يوم؟	كم السعر لنصف يوم ؟
انا كنجي.	أنا كينجي .
هل بتعرف اي أماكن جيدة للرؤية في شيكاغو؟	هل تعرف أي أماكن جيدة لمشاهدتها في شيكاجو ؟
طيب، إذا انتو الاتنين مصرين، ح أمشي معاكم.	حسناً ، في حالة إصرار كليكما , سأذهب معكما .
داير اعمل حجز لتلاتة و نص بعد الظهر.	أريد القيام بحجز للساعة الثالثة والنصف ظهراُ .
صندوق الأمان، من فضلك.	خزينة الودائع , من فضلك .
من فضلك، شيل خمرة مناسبة.	من فضلك أحضر نبيذاً مناسباُ .
هل مفروض ادفع للبنزين؟	هل مطلوب منى دفع ثمن الغاز ؟
حرامي. اقبضه.	لص . أمسكوا به .
هي رشيقة و لطيفة.	إنها صغيرة الجسم وذكية .
مقلي، من فضلك.	مقلي من فضلك .
غسيلي ما اترجع لسة.	غسيلي لم يرجع حتى الآن .
بالمناسبة، انت فاضي السبت الجاي دا؟	على فكرة , هل أنت غير مشغول السبت القادم ؟
طيب، احتمال نحن ح نكون كويسين لفترة طويلة معا.	حسناً ، إذن , ربما سننسجم مع بعضنا .
هي بتعاملني زي لو كنت شحاد.	إنها عاملتني كما لو كنت متسولاُ .
ممكن تخت عدسات طبية في النظارات الشمسية دي؟	هل يمكنك وضع عدسات نظر في هذا النظارة الشمسية ؟
ما الطفهم من كلاب. ياتو فصيلة؟	يا لها من كلاب ذكية . من أي فصيلة ؟
وقعت مفراكتي. من فضلك جيب واحدة اخرى.	وقعت منى الشوكة . من فضلك أحضر واحدة أخرى .
داك كان ظريف.	كان هذا ممتعاً .
اكيد. أمشي دغري و لف يمين عند الكورنة التالتة. ح تلقاه على يمينك.	بالتأكيد . سر في خط مستقيم ثم اتجه يميناُ عند الناصية الثالثة . ستجده على يمينك .
هل تعرف كاثي؟ أنه عيد ميلادها.	أتعرف كاثي ؟ إنه عيد ميلادها .
هل عندك مخطط ملون؟	هل لديك لوحة موضوع عليها الألوان ؟
لكن، هو، رجل، كيف أعرف داك الشئ الحقيقي؟	لكن ، هو , يا رجل كيف أعرف أنه الشيء الحقيقة ؟
ما قادر أخت عفشي تحت المقعد. ممكن تمسكوا لي، من فضلك؟	لا يمكنني وضع الأمتعة تحت المقعد . هل لك أن تحتفظ بها لأجلي من فضلك ؟
ممكن من فضلك تخت الشنطة دي في شنطة العربية؟	هل يمكن أن تضع حقيبة السفر هذه في صندوق السيارة .
انا طالع أسى، عشان كدا ح ارفعه.	أنا خارج الآن . لذلك سآخذها .
من فضلك رسل زول فوق لي شنطي عند ستة و تلاتين.	من فضلك أرسل أحداً للطابق العلوي ليأخذ حقائبي الساعة السادسة والنصف .
وين المصعد؟	أين المصعد ؟
شكرا ليك، لكن ما أظن عندي زمن اقعد ليلتين. ممكن تحجز لي غرفة مزدوجة في الفندق داك لليلة اتناشر مارس بس؟	شكراً . لكنني لا أعتقد أن عندي وقت للإقامة لمدة ليلتين . هل يمكنك حجز غرفة بسريرين لي في ذلك الفندق ليلة الثاني عشر من مارس فقط ؟
ما قررنا لسة.	لم نقرر بعد .
صحبي اتعتر و لوا كاحله.	تعثر صديقي والتوي كاحله .
ح أجرب بعض العصير.	سأجرب بعضاً من الشراب المثلج .
إنه قرب ذلك المبنى. عشان كدا، أرجع بنفس الشارع الجيت بيه لغاية الإشارة. ثم، لف للشمال.	إنها بجور ذلك المبنى المرتفع . لذلك ارجع في نفس الطريق الذي أتيت منه حتى إشارة المرور . ثم اتجه يساراً .
مفروض احصل طائرة لي لوس أنجلس بدري صباح بكرة.	علي أن ألحق طائرة متجهة للوس أنجليس باكر صباح غد .
"ثم انا ممكن بوثوق أزكى ""جولة مدينة سان فرانسيسكو""دي. دي بتعرفك الخطوط العريضة لسان فرانسيسكو."	إذاً يمكنني بكل ثقة أن أزكي برج مدينة سان فرانسيسكو . فهذا يعطيك فكره عن سان فرانسيسكو .
داير احصل على تأمين.	أريد الحصول على تأمين .
دايرة تشتري فستان.	تريد أن تشتري ثوبا .
كم التكسي للفندق دا؟	كم أجرة التاكسي حتى هذا الفندق ؟
وين المرحاض؟	أين الحمام ؟
اخدها في طريقك.	قم بها بطريقتك .
نص أوقية من جانل رقم خمسة، من فضلك.	نصف أوقية من شانيل رقم خمسة من فضلك .
ماذا عن بعض القهوة؟	ما رأيك في بعض القهوة ؟
هل بحتاج لي تزكرة؟	هل أنا بحاجة إلى تذكرة ؟
حوالي كم سعر الخدمة؟	ما هي تكلفة الخدمة تقريبا ؟
كم البعد من هنا؟	كم المدة التي يستغرقها من هنا ؟
كريم و سكر؟	كريمة وسكر ؟
هل عندك معدل نقصان للأعضاء؟	هل ثمة تخفيضات للأعضاء المشاركين ؟
هل هناك سوبر اكسبرس تسعة و نص؟	هل هناك قطار فائق السرعة في التاسعة والنصف ؟
خليني أراجع سائل الفرامل و المحرك . محركك شكله خلاص وقف.	دعني افحص سائل الفرامل والمحرك . يبدو أن محرك سيارتك قد أوشك علي التوقف .
ما كان غلطي.	لم يكن خطئي .
ما في كهرباء.	لا كهرباء .
هل اي زول مفروض يدفع لي مشروباتو؟	هل سيحاسب كل واحد منا على مشروباته منفردا ؟
اي محل من تلاتين لخمسين دولار لليلة.	في أي مكان من ثلاثين حتى خمسين دولارا لليلة .
في أيام رأس السنة. و في المناسبات الخاصة زي استقبال العرس، حفلات الجائزة أو العزاء.	في أيام السنة الجديدة . وفي مناسبات خاصة مثل حفلات الزواج ومراسم منح الجوائز أو في العزاء .
لي ما تديها هدية؟	لماذا لا تعطيها هدية ؟
هي ضربتني بالجنبة.	لقد انتقدتني ضمنا .
ممكن اجي عند التانية.	يمكن أن أحضر في الساعة الثانية .
دي رحلتي الأولى لباريس.	هذه هي رحلتي الأولى إلى باريس .
ممكن تخمن التكلفة قبل ما تبدأ الشغل فيه؟	هل لك أن تقدر التكلفة قبل أن تبدأ العمل فيها ؟
أدخل، من فضلك.	تعالى ، من فضلك .
داير العب تنس.	أود لعب التنس .
هناك في أناناس، برتقال و عصير طماطم.	يوجد عصير أناناس وبرتقال وطماطم .
جانب شمالي للطابق دا، جنب المصعد.	الجانب الأيسر من هذه الدور بجوار المصعد .
ما ممكن بالأحرى تشوف فلم مختلف؟	ما رأيك في مشاهدة فيلم آخر ؟
من فضلك حول شيك المسافر دا لكاش.	من فضلك ، بدلي شيك المسافرين إلي نقود .
انا من المحتمل اقدر اديك إجابة أفضل لداك بعد جوز من العروض.	ربما أعطيك إجابة أفضل من تلك بعد عرضين .
ياتو ملعوبة موسيقية شغالة أسى؟	ما هي المسرحيات الموسيقية المعروضة حاليا ؟
هل عندك مراية؟	هل لديك مرآة ؟
ح اخد الواحد دا، من فضلك.	سوف آخذ هذه ، من فضلك .
ما ممكن تجيب العاب نارية إلى كندا.	لا يمكنك جلب الألعاب النارية إلى كندا .
داير أي مساعدة؟	هل تريد أي مساعدة ؟
المكان دا ملئ بالناس، ول لا؟	هذا المكان مكتظ بالناسب ، أليس كذلك ؟
معليش. ح يكونوا جاهزين في حوالي خمسة دقايق.	عفواً . ستكون جاهزة في غضون خمس دقائق .
في ياتو زمن مفروض اكون في المحطة؟	متى يتعين علي أن أكون في المحطة ؟
في مطاعم كتيرة حوالي هنا.	هناك مطاعم كثيرة قريبة من هنا .
هو بعد غرفة الامانات.	بجوار حجرة الإيداع .
كلام سمح معاك.	إنه لمن دواعي السرور أن أتحدث معك .
استمتعت بي قعدتي. شكرا.	لقد تمتعت بإقامتي . شكراً لك .
الشاطئ تحت، ما أجمله من منظر.	الشاطئ أسفل يمينا . ياله من منظر رائع .
شكرا ليك للانتظار، مس مسقاير. هو هنا. اتفضلي. من فضلك.	شكراً لك على الانتظار ، يا أستاذه مكجوير . هاك هو . امض من فضلك .
هل عندك هوية فيها صورة؟	هل لديك أي صورة لبطاقة هوية ؟
داير أرسل دا للمغسلة . متين ح يكون جاهز؟	أريد أن أرسل هذا إلى المغسلة . متى ستكون جاهزة ؟
عندي بنطلون مخطط.	لقد خلعت البنطلون .
ممكن احصل عليه موضح أكتر بالتفصيل؟	هل من الممكن أن تفصل أكثر ؟
هو في نهاية الممر.	في نهاية الممر .
نحن ماشين بالبص؟	هل سنذهب بالحافلة ؟
انت قلت انك مغادر إلى توكيو بكرة؟	هل قلت إنك ستغادر إلى طوكيو غدا ؟
مفروض احول إلى أي دبليو واحد صفر صفر. هل ممكن؟	يجب أن أنتقل إلى عربة مكيفة واحد صفر صفر . هل هذا ممكن ؟
لعبتك كيف الأيام دي؟	كيف حال اللعب معك هذه الأيام ؟
هل عندك اي جولة تانية؟	هل لديكم أية جولة سياحية أخرى ؟
كلو تمام، خمسة في المية خصم. كدا اوكي؟	حسنا . خصم خمسة في المائة . هل يوافقك لك ؟
انا ماشى لي باريس.	إنني ذاهب إلى باريس .
هو ما آخر موديل، ول لا؟	إنها ليست أحدث طراز ، أليس كذلك ؟
هو اتجدول لتمنية و تلاتين في المساء توقيت محلي.	موعده المقرر هو الثامنة والنصف مساءْ بالتوقيت المحلي .
اوكي. ح اخد صحن مقاس متوسط و كورة رز.	حسناً . أريد سلطانية من الحجم المتوسط ، وكرات الأرز .
كيف يبدو هذا؟	كيف يبدو هذا ؟
داير اشوف الواحد داك في النافذة، من فضلك.	أريد أن أرى ذاك الذي في نافذة العرض ، من فضلك .
ماف طريقة. نحن في فاكيشن. أنا ارفض ان اقعد في غرفة فندق و أشاهد بيسبول في التلفزيون. داير أمشي أحضر مسرحية.	مستحيل . نحن في إجازة . إنني أرفض الجلوس في غرفة بالفندق ومشاهدة البيسبول في التلفاز . أريد الذهاب لمشاهدة مسرحية .
ممكن ألمسه؟	هل بإمكاني اللمس ؟
ممكن تجي هنا عشان تصلحوا؟	أيمكنك الحضور إلى هنا لإصلاحه ؟
داير بعض الفايبر الصناعي.	أريد بعض الألياف الصناعية .
اسمي تارو تاكانا. عندي حجز.	"اسمي "" تارو تاناكا "" لدي حجز مسبق ."
داير بعض كريم التطهير.	أريد بعضاً من كريم التنظيف .
داير بلوزة مع أكمام طويلة.	أريد رداءا ذات أكمام طويلة .
اتسرقت مني شنطتي.	لقد سُرقت حقيبتي .
طرقاتنا شكلها بتتعارض مرات كتيرة. ول لا؟	لقد تقابلنا بالصدفة لعدة مرات ، أليس كذلك ؟
ممكن اشوف القائمة تاني؟	هل يمكنني أن ألقي نظرةً أخرى على قائمة الطعام ؟
هم لسة بظهروا خضر شوية.	لا تزال تبدو عليهم علامات المرض وشحوبة الوجه .
كم عدد؟	كم عددها ؟
فراولة، من فضلك.	فراولة ، من فضلك .
ممكن تقصر الأكمام؟	هل لك أن تقصّر الأكمام ؟
آسف ما في ملعب قولف قريب هنا.	أخشى أن لا يكون هنا أية دورة لتعليم الجولف .
ممكن توريني الخاتم التاني من الشمال؟	هل لك أن تريني الخاتم الثاني من جهة اليسار ؟
ممكن تطلب منه يتصل علي؟	ألا تسأله أن يتصل بي ؟
حاولت اعمل مكالمة دولية؟	لقد حاولت إجراء مكالمة دولية ، هل نجح ذلك معك من قبل ؟
نعم، دا هو. لأنك ممكن تشوف العلم في مقدمة مكتب البريد.	نعم ، هي ، لأنك تستطيع أن ترى العلم أمام مكتب البريد .
داير حقي يمشي.	أريد ما يخصني لكي أرحل .
عندما يوصل. ح ندفع عشان نشحنوا إلى عنوان منزلك.	لدي وصولها ، سوف ندفع ثمن شحنها إلى عنوان منزلك .
اوه، اوكي. فهمت. ح اجي لي محلك.	أوه ! موافق ، لقد فهمت ، سوف آتي إلى مكانك .
ممكن تجي هنا بسرعة قدر الإمكان، من فضلك؟	هل يمكنك أن تحضر هنا قريباً بقدر المستطاع ، من فضلك ؟
كباية قهوة، من فضلك.	قدحاً من القهوة , من فضلك .
ممكن تضيق الخصر تلاتة سنتيمترات؟	هل لك بأن تضيق منطقة الوسط سنتيمترات ؟
انا نفس العمر.	إنني في نفس السن .
ح تجيب لي بعض القهوة؟	ألا تحضر لي بعض القهوة ؟
هل نحن محتاجين نخت دا في تصويت؟ إذا لا، أعتقد إننا وصلنا لخاتمة ال ح أرسلها لمجلس ادارتنا صباح بكرة.	هل نحتاج إلى طرح هذا للتصويت ؟ إن لم نكن في حاجة إلى هذا ، فإمكاني أن أعتقد حينئذ أننا قد وصلنا إلى نتيجة , سأقوم بإرسالها إلى مجلس إدارتنا صباح غد .
هل تعلم إذا كان هناك أي فنادق رخيصة؟	هل تعرف ما إذا كان هناك أي فنادق رخيصة الأسعار ؟
صباح الخير. هل نمت كويس؟	صباح الخير . هل استرحت في نومك ؟
ماذا تنوي ان تفعل بعد أن تنهي المدرسة؟	ماذا تنوي أن تفعل عقب الانتهاء من المدرسة . ؟
هل عندك اي خدمات تانية بجانب الفطور الصباح دا؟	هل كان لديك أية خدمات أخرى إلى جانب طعام الإفطار هذا الصباح ؟
داير كباية قهوة بيضاء، من فضلك.	من فضلك ، أريد فنجاناً من القهوة البيضاء .
أتمنى انك ما تعبان شديد.	أتمنى ألا تكون متعبا جدا .
داير أأجر عربية من النوع دا ليومين.	أبغي تأجير سيارة من هذا الطراز لمدة يومين .
ح آخد لقطة بتاعت جاك دانيلس.	سآخذ صورة لجاك دانيلز .
نحن ما بنجيب هدايا للاستقبال. كبديل، الضيوف بجيبوا كاش.	نحن لا نجلب أية هدايا إلى الحفل ، وبدلا من ذلك يحضر الضيوف أموالاً نقدية .
داير أرسله بالبريد البري او البحري.	أود أن أرسله عن طريق البريد .
ممكن اخد صور؟	هل يمكنني أن التقط بعض الصور ؟
خارج المئة.	من مائة .
ممكن اخد نفس الصحن زي داك؟	هل بإمكاني الحصول على طبق آخر مثل هذا ؟
من فضلك جيب فطوري لغرفتي عند السابعة صباح بكرة.	من فضلك ، احضر طعام الإفطار إلى غرفتي في السابعة من صباح الغد .
هل هناك أي شواغر في جولة الخميس؟	هل هناك أماكن شاغرة بالنسبة لرحلة الخميس ؟
اعذرني . ممكن أمر؟	عفواً . هلا سمحت لي بالمرور ؟
هل عندك اي نبتات و فواكه؟	هل لديك أية نباتات أو فواكه ؟
هل الأكل دا منخفض في السعرات الحرارية؟	هل هذا الطعام منخفض السعرات الحرارية ؟
أي بص مفروض اخد عشان أمشي المحطة؟	أية حافلة يجب أن آخذ إلى المحطة ؟
نعم، دا هو. لكن عليك أن تلف شمال في الإشارة التالتة و تبقى في الشارع داك لغاية تجي للشارع ستة وستين.	نعم , إنه هو . ولكن ستضطر إلى الدوران يسارا في إشارة المرور الثالثة وتستمر في ذلك الشارع حتى تصل إلى الطريق رقم ستة وستين .
أنا آسف. عندك الرقم غلط. دي تانكيوشا بريس.	آسف . لقد اتصلت بالرقم الخطأ . هذه وكالة تانكيوشا الصحفية .
بنغادر.	إننا سندفع الحساب ونغادر .
من فضلك أدى العصير دا لطفلك، مقاس واحد، بعد كل وجبة.	من فضلك أعط طفلك هذا الدواء الشراب , جرعة واحدة بعد كل وجبة .
الاستايل متوفر في المقاسات تمنية وعشرين، واحد وتلاتين و خمسة وتلاتين سنتيمتر .	هذا الموديل متوفر بمقاسات ثمانية وعشرين , وواحد وثلاثين وخمسة وثلاثين سنتيمترا .
داير أأكد رحلتي لشيكاغو يوم سبعتاشر.	أريد أن أعيد التأكيد على رحلتي إلى شيكاغو في السابع عشر .
أنا اكلت كتير شديد شوية.	أكلت كثيرا نوعا ما .
ممكن اتكلم مع مس براون؟	هل يمكن أن أتحدث إلى السيدة براون ؟
البيت دا يبدو أن مريح للمعيشة فيه، ول لا؟	هذا البيت يبدو مريحا للمعيشة فيه , أليس كذلك ؟
متين بتقفل؟	متى تغلقون ؟
داك نفس الكنت ح اقولوا.	هذا بالضبط ما كنت سأقوله .
نعم، أظن كدا.	نعم , أعتقد ذلك .
بيتك كبير. كم غرفة؟	منزلك كبير . كم عدد الغرف ؟
استمتعنا بالعشاء.	استمتعنا بالعشاء .
اوه، نعم، من فضلك. بس انا بتمنى ما يصيبهم دوار البحر.	أوو ، نعم ، من فضلك . أنا أتمنى أن لا يصابوا بدوار البحر .
زمن الوصول المتوقع حقنا شنو؟	ما هو موعد وصولنا المقدر ؟
انا مغادر بدري بكرة، عشان كده داير ادفع أسى.	سأغادر باكراً غداً ، لذلك أود أن أدفع الآن .
هو مشغول الآن.	هو مشغول الآن .
هل يمكن للأجانب الوصول للكتب في المكتبة دي؟	هل الأجانب يمكنهم الحصول على الكتب في المكتبة ؟
هل ممكن اقعد في غرفتي لغاية اتنين بعد الظهر؟	هل من الممكن أن أمكث في غرفتي حتى الثانية مساءً ؟
ها-ها صباح الخير وقتك. اوكي.	ها-ها . صباح الخير حان دورك . إنه على ما يرام .
داير فيلم من رقم ال ايه اس ايه ده للكاميرا دي، من فضلك.	أود بعضاً من فيلم رقم ايه إس ايه لهذه الكاميرا ، من فضلك .
وين دهانات مونت؟	أين رسومات مونيت ؟
البيتزا دي لذيذة. العملها منو؟	البيتزا لذيذة . من صنعها ؟
برضه هم غالين.	هم أيضاً غاليين .
متين بغادر القطر التالي إلى بوسطن؟	متى يغادر القطار التالي إلى بوسطن ؟
راكب الموج ده جيد جدا.	يا له من راكب ماهر للأمواج .
آسف الأكمام قصيرة جدا.	أخشى أن تكون الأكمام قصيرة جدا .
ممكن توريني كيف أخت البنزين؟	هل يمكنك أن تريني كيف أضع الغاز ؟
هل رسوم الفندق بتشمل الفطور؟	هل أجرة الفندق تضم الإفطار ؟
هل دا كل شي؟	هل هذا كل شيء ؟
هو في الطريق دا.	إنه في نهاية هذا الطريق .
من فضلك أبدا العداد.	من فضلك ابدأ العداد .
غرفتي باردة شديد.	غرفتي أبرد من اللازم .
أشعر بتحسن.	أشعر بتحسن .
من فضلك توريني لمن اكون في الخريطة دي.	من فضلك أرني أين أنا على هذه الخريطة .
مئة في المئة قطن.	مائة بالمائة قطن .
داير أبدل لغرفة مطلة على المحيط. هل هناك اي مصاريف إضافية؟	أود أن أغير لغرفة تطل على المحيط . هل توجد أي رسوم إضافية ؟
كم سعر اجار لوحة نص يوم؟	كم ثمن إيجار نصف يوم للوحة ؟
عشرة نوفمبر.	العاشر من نوفمبر .
إنه طاعم جدا.	إنها لذيذة جداً .
عملت حجز في طوكيو قبل شهر.	عملت الحجز في طوكيو منذ شهر .
أشكرك من أعماق قلبي.	أشكرك من أعماق قلبي .
من فضلك قيس مقاس حذائي.	من فضلك قس حجم حذائي .
إنه رائع.	إنها رائعة .
ممكن تطلع معاي في موعد؟	هل ستحدد موعداً للخروج معي ؟
من فضلك نضف الجاكيت دا.	من فضلك نظف هذا المعطف .
داير أأجر مركب بمحرك.	أود أن أؤجر قارب بمحرك .
وين قسم السيدات؟	أين قسم السيدات ؟
خالي قهوة؟	القهوة غير محسوبة .
في أي حقل كان هو؟	في أي مجال كان من قبل ؟
العنة. العنة. العنة. العنة. اتعودت على وجهها.	اللعنة . اللعنة . اللعنة . اللعنة . لقد كبرت معتاداً على وجهها .
هل مفروض ادفع الرسوم لم ادخل المبنى؟	هل يجب أن أدفع الرسم الإضافي عندما أدخل مبنى ؟
عندي قشعريرة.	عندي قشعريرة .
تلاتة أيام.	ثلاثة أيام .
ما داير واحد كبير.	لا أريد واحدة ضخمة .
ح يكون هناك تأخير طفيف.	سيكون هناك تأخير بسيط .
كان عظيم. شكرا ليك.	كان عظيماً . شكراً .
هل عندك اي شي أطول شوية؟	هل لديك أي شيء لفترة أطول قليلاً ؟
هل هناك اي كازينوهات جيدة؟	هل توجد أية كازينوهات جيدة ؟
دي القروش لاقلام الحبر. فاتورة مئة دولار.	هذه هي فلوس أقلام الحبر . فاتورة بمائة دولار .
وين قطاع السيدات؟	أين قسم السيدات ؟
وين انا ممكن اركب القارب؟	أين يمكن أن أركب القارب ؟
صاحبي اتجرح.	صديقي مصاب .
تبدوا بخير.	تبدو بصحة جيدة .
هل ممكن من فضلك تقلم الشنب؟	هل يمكنك أن تشذب شاربي ؟
ما بقدر ابيع دا بدون وصفة.	لا يمكن أن أبيع هذه دون روشتة .
ممكن احجز خمسة مقاعد سوا في نفس الصف؟	هل يمكن أن أحجز خمسة مقاعد في الصف نفسه .
ما ح تلقى تخفيض مهما حاولت بصعوبة.	لن تأخذ خصماً مهما حاولت .
ممكن تفتح الشنطة دي، من فضلك؟ عندك شنو هنا؟	هلا فتحت هذه الحقيبة ، من فضلك ؟ ماذا يوجد هنا .
داير اعمل مكالمة بعيدة . المسافة للهيلتون هوتل في بوسطن.	أريد أن أعمل مكالمة مسافة طويلة إلى فندق هيلتون في بوسطن .
احذر، سقف منخفض.	كن حذراً ، السقف منخفض .
ما قادر اشوف الشاشة كويس من هنا. ممكن ابدل المقاعد لفترة؟	لا أستطيع رؤية الشاشة جيداً من هنا ، هل يمكنني تبديل المقاعد لبعض الوقت ؟
محتاج لدكتور.	أحتاج إلى طيب .
محب للفنون الجديدة زي نفسك ربما من المحتمل يستمتع بلوحات الهيبيش و مشهد موسيقي الشارع.	من المرجح أن محبا للإبداع الفني مثلك سيستمتع اللوحات الزيتية غير التقليدية وعروض الموسيقى بالشوارع .
ياتو زمن؟	كم الوقت ؟
ممكن تشوف مبنى ابيض، صاح؟ هو أمام المبنى داك.	يمكنك رؤية مبنى ابيض اللون ، أليس كذلك ؟ إنه أمام ذلك المبنى .
صحبي عيان شديد. ممكن تنادي دكتور، من فضلك.	اليابانيون لا يأخذون إجازات طويلة .
حاسي اني زي البقيت مبحلق . هل هو نادر انك تشوف زول ياباني؟	اشعر كأن هناك تحديق في . هل من النادر رؤية شخص ياباني ؟
وين مستودع بص القريهند في المدينة دي؟	أين محطة أتوبيس جرايهاوند في هذه البلدة ؟
لكن مش المطاعم اليابانية في كيوتو غالية؟	أليست المطاعم اليابانية في كيوتو غالية ، بالرغم من ذلك ؟
أعتقد أنه عالي بسيط بالنسبة لي.	اعتقد أن هذا عالي قليلا بالنسبة لي .
داير معدل الكتاب.	أريد سعر الكتاب .
ح يكون عندي مقاعد درجة رجال الاعمال، صاح؟	سآخذ مقاعد درجة رجال أعمال ، أليس كذلك ؟
ممكن آخد دا و دا، من فضلك؟	هل لي بهذه وهذه ، من فضلك ؟
بقولوا اليابان بلد غني شديد.	يقولون أن اليابان دولة غنية جداً .
التلج جعل الممر منزلق.	الثلج يجعل الطريق زلق .
ما قادر القي كاميرتي.	لا أستطيع أن أجد كاميرتي .
عندك اي شي للتوضيح؟	هل لديك أي شئ لإعلانه ؟
هل شفت جاكيت أزرق؟ ختيته على الكرسي دا.	هل رأيت معطف أزرق ؟ وضعته على هذا الكرسي .
أنا من طوكيو.	أنا من طوكيو .
داير كريم شطف ريفلون.	أريد بعض الغسول لإزالة كريم ريفلون .
عندي شوية حاجات للغسيل.	لدي بعض الملابس للمغسلة .
ح اخد شوكولاتة سخنة.	سآخذ شيكولاتة ساخنة .
ممكن نرتب لجعل غرفتك نضيفة.	نستطيع أن نرتب لتنظيف غرفاتكم .
خاص، من فضلك.	خاص من فضلك .
كم التكلفة إلى الفندق سي؟	كم تكلفة الذهاب إلى فندق سي ؟
داير بعض كريم الليل.	أريد بعض الكريم الليلي .
ممكن تلف دي زي هدية؟	هل لك أن تغلف هذه كالهدية ؟
انها تلاتة و ربع.	إنها الثالثة والربع .
ح أخطط أرسل الفواتير لاحتياجاتي اليومية، عشان كده وريني العنوان و الاسم بتاع الزول المسؤول.	سأخطط لإرسال فواتير حاجياتي اليومية ، لذا من فضلك أخبرني العنوان و اسم الشخص المسئول من فضلك .
هل عندك ديل في نفس التصميم مع كعوب أعلى؟	هل لديك نفس هذا التصميم بكعب أعلى ؟
داير بلوفر لطفل عمره عشرة سنوات.	أريد جاكيت لطفل في العاشرة من العمر .
وديني لطريق آبي، من فضلك.	خذني إلى طريق أباي , من فضلك .
أنا متأكد اني عندي حجز.	أنا متأكد أن لدى حجز .
عندي صداع خفيف.	أشعر بصداع خفيف .
استمتعت شديد بالوجبة.	لقد استمتعت بالوجبة كثيراً جداً .
لا، من فضلك اخد مقعد وانتظر . ح اجي راجع حالا.	لا ، من فضلك اجلس وانتظر . سأعود بعد قليل .
ممكن ترسم لي خريطة، من فضلك؟	هل لك أن ترسم لي خريطة , من فضلك ؟
أنا اتسرقت في وايماتالو بيتش. من فضلك تعال الآن.	لقد سرقت في شاطئ وايمانالو . من فضلك تعالى فوراً .
كيف عن مية دولار؟	ماذا عن مائة دولار ؟
داير دا محزوم.	أريد هذا معبئاً .
عمره تعدى الخمسين سنة، افترض.	أعتقد أن عمره أكثر من خمسين سنة .
عندك اي خرائط بسيطة للمدينة؟	هل لديك أيّ خرائط بسيطة للمدينة ؟
داير آخد نظرة لصندوقك.	آوه إلقاء نظرة على صندوقك .
داير بعض الشامبو.	أريد بعض الشامبو .
أنا حاسي كعب و مقيئ.	أشعر بحالة سيئة وغثيان .
لكن انا عندي موعد عشان اشوفها الساعة اتنين.	لكنّي لدى موعد لرؤيتها في السّاعة الثّانية .
هل العربية دي بتمشي إلى ادينبيره؟	هل تذهب هذه السيارة إلى إدنبرة ؟
نعم، من فضلك املأ الفورمة دي.	نعم ، رجاءً املأ هذه الاستمارة .
كم السعر الانت بتاجر بيه للوزن الزائد؟	ما هو مقدار الرسوم للوزن الزائد ؟
ياتو زمن المغادرة؟	في أي وقت يمكنني مغادرة الفندق ؟
حصلت عليه.	فهمت الأمر .
ح اتصل بي زول.	سوف أطلب شخصاً ما .
العربية جات على من الجانب في التقاطع.	السيارة جاءت لي من الجانب عند التقاطع .
إنه صندوق موسيقى.	إنه صندوق موسيقى .
وين الضاحية؟	أين الضاحية ؟
بنبدا في ياتو زمن؟	في أي وقت نبدأ ؟
كله تمام، سيدي. في المقاس الوسط ممكن نوفر ليك سمور زئبقي. هل داك كله تمام؟	"حسنا ، يا سيدي . في الحجم المتوسط نعرض عليك فرو السمور من نوع "" ميركوري "" ، فهل ذلك يوافقك ؟"
انت عندك كدمة عضلة.	لقد تسببتّ في كَدْمة بالعَضَلة .
لكن لازم توعدني انك تضرب الكورة، ما انا . اوكي؟	ولكن عليك أن تعدني بركل الكرة ، وليس أنا . موافق ؟
ممكن استعير بعض الكتان؟	هل لي في استعارة بعض البياضات ؟
ما نوع الجلد المصنوعة منه الشنطة دي؟	من أي نوع من الجلد الصناعي صُنعت حقيبة السفر هذه ؟
هل دا الشارع الصحيح إلى سنترال استيشن؟	هل هذا هو الطريق الصحيح إلى المحطة المركزية ؟
داير أطلب لي بدلة غامضة اللون.	أود أن أطلب بدلة داكنة من أجلي .
من فضلك وريني جوازك.	من فضلك أرني جواز سفرك .
هل هناك اي مكان بقبل الغسيل في أيام الأحد؟	هل يوجد مكان يقبل تنظيف الملابس في أيام الآحاد ؟
اتنين بيرقر جبنة، من فضلك.	سندويتشان برجر بالجبن ، من فضلك .
لكن البقشيش ما ضروري.	ولكن لا ضرورة لدفع بقشيش .
ممكن تشوف واحد في قاعة كارنيغي.	"بمقدورك أن ترى واحداً عند "" كارينجي هول "" ."
ما هي خصوصيات البيت؟	ما هو الصنف المميز للمحل ؟
داير اعمل موعد مع دكتور.	أودّ حجز موعد مع طبيب .
يبدو أن هناك مجال للتحسين.	يبدو أن ثمة مجالات للتحسينات .
وين التحت الواطة؟	أين مترو الأنفاق ؟
هل هو عندك في مقاس اصغر؟	هل عندكم منه بحجم أصغر ؟
وين ممكن احصل على اسبرين؟	أين يمكنني الحصول على أسبرين ؟
داك زر الروك؟	ذلك الحد الأدنى للسعر .
من فضلك اديني مرور أسبوع واحد.	من فضلك اعطني تصريحاً سارياً لمدة أسبوع .
دي كليتي.	هذا زميلي .
نوع البنزين هناك شنو؟ ممتاز، عادي، ونقي؟	أي نوع من البنزين هناك ؟ السوبر ، أم العادي ، أما الخالي من الرصاص ؟
دا واحد.	هنا واحد .
حيصيبني برد.	أنا مقبل على الإصابة بنوبة برد .
هو انجليس مشوي مع صلصة خاصة في قمة صحن رز.	إنه سمك ثعبان مشوي مع مرقة خاصة فوق سلطانية من الأرز .
"هو قال ""خلينا نحتفل"" و اخدني للبار. هو قال إن ماشى يعمل مكالمة هاتفية و غادر و نهائي ما جا راجع و أنا علقت مع فاتورة كبيرة."	دعونا نحتفل  ، هكذا قال وآخذني إلى بار . وقال إنه سيُجري مكالمة هاتفية وغادر ولم يعد أبداً وتحملت أنا وحدي عبء فاتورة ضخمة .
عندي جوازي و الكردت كارد في شنطتي.	كان معي جواز سفري وبطاقتي الائتمانية في جيبي .
حجز عند السابعة، تحت اسم مانو.	الحجوزات في السابعة ، تحت اسم مانو .
ما ح تاخد كباية شاي؟	ألا ترغب في فنجان شاي ؟
هو دائما بتسوق في شارع بوند.	"إنه يقوم دائماً بالتسوق في شارع "" بوند "" ."
ورقة انجليزي، من فضلك.	جريدة باللغة الإنجليزية ، لطفاً .
هل هناك اي محل بشغل موسيقى ريفية؟	هل هناك مكان يتم فيه عزف الموسيقي الريفية ؟
اي واحدات صوفية تانية؟	أي منتجات صوفية أخرى ؟
كم السعر بي الشيت؟	كم تكلف الملاءة الواحدة ؟
طيب، اضغط تسعة و صفر واحد واحد، ثم مفتاح الدولة و رقم الهاتف.	حسنا ، اضغط تسعة وصفر واحد واحد ، ثم الكود الخاص بالبلد ورقم الهاتف .
ممكن احصل على دايت كوكا؟	هل يمكن أن أحصل على كوكاكولا دايت ؟
ممكن أضع طلب؟	هل بإمكاني إجراء طلبية ؟
عندنا قيادة جميلة. شكرا ليك.	استمتعنا بجولة لطيفة بالسيارة . شكراً لك .
التعداد الكلي لسكان اليابان حوالي مئة و تلاتين مليون.	إجمالي سكان اليابان حوالي مائة وثلاثين مليوناً .
داير أأجر شمسية.	أود استئجار شمسية .
نعم، و أنا داير أراجع الرسوم.	أجل ، وأودّ محاسبة المطلوب هاتفياً على قيمة المكالمة .
محفظة بمية دولار و اتنين كردت كارد.	محفظة بها مائة دولار وبطاقتان ائتمانيتان .
موية ساخنة شديد.	الماء أسخن من اللازم .
انت هنا.	أنت هنا .
غير مرجح بشكل عالي.	غير محتمل بدرجة كبيرة .
بطني بتوجع بعد الوجبات.	معدتي تؤلمني بعد الوجبات .
وااااو، داك مكان جميل.	عظيم ، ذلك مكان لطيف .
هو احتمال يكون عنده جلطة.	ربما كان يعاني سّدَّة تنفسية .
انت قررت؟	هل قرّرتَ ؟
لو داير، ح نحجز هنا.	إذا كنت تودّ ، بإمكاننا الاستراحة هنا .
كله تمام، لكن ما المدرجات . هي حارة شديد اليوم.	حسنا ، ولكن ليس منطقة المقاعد المكشوفة . فاليوم شديد الحرارة .
أنا لسة حاسي بنفسي بستفرغ.	مازلت أشعر بالرغبة في القيء .
راجع، من فضلك.	الحساب ، من فضلك .
اشحن، من فضلك. بتاخد فيزا؟	التكلفة ، من فضلك . هل تقبلون بطاقة فيزا ؟
اليوم ح أمشي اشوف شايناتاون عاملة كيف.	اليوم سأذهب لأرى كيف يبدو الحيّ الصين .
اتنين صفر اتنين تسعة تلاتة تسعة ستة سبعة صفر صفر.	اثنان صفر اثنان تسعة ثلاثة تسعة ستة سبعة صفر صفر .
داير سني تتقلع.	أرغب في خلع أسناني .
داير شنطة كريمات.	أرغب في حقيبة مستحضرات تجميل .
"وين ممكن اشوف""الخيال بتاع أوبرا""؟"	"أين يمكنني مشاهدة عَرْض "" شبح الأوبرا "" ؟"
ببطء أكتر، من فضلك.	بطريقة أبطأ ، من فضلك .
مقلي بالجنبتين، من فضلك.	مقلية على الجانبين ، من فضلك .
ح يكون جاهز بعد بكرة في المساء.	سيكون جاهزا بعد غد في المساء .
هل دا معمول من القطن؟	هل هذا مصنوع من القطن ؟
نعم، هناك في مشروب واحد على الأقل.	نعم , يوجد مشروب على الأقل .
كم سعره في اليوم؟	ما تكلفة هذا في اليوم ؟
داير سي دي.	أريد اسطوانة مدمجة .
في رحلات الخطوط الجوية اليابانية وأول نيبون البغادروا عند عشرة و خمسة وخمسين. لكن، لسوء الحظ الرحلتين ملان.	توجد رحلات جوية على شركات جال وانا التي تقلع في الساعة العاشرة وخمسة وخمسين دقيقة . ولكن , للأسف كلتا الرحلتين محجوزتان .
هو بناسبني تمام.	تناسبني تماما .
ممكن نحصل على طربيزة لخمسة؟	هل يمكن أن نحجز طاولة لخمسة أشخاص ؟
هي ما بتفهم انجليزي نهائي.	إنها لا تفهم الإنجليزية مطلقا .
ممكن تهتم بيها من تسعة صباحا إلى حوالي تلاتة؟	هل يمكن أن تعتني بها من الساعة التاسعة صباحا حتى الثالثة ؟
انا اتقفلت. ممكن تفتح بابي، من فضلك.	لقد أُغلق علي الباب . هل يمكن أن تفتح بابي , من فضلك ؟
ياتو جولة أحسن لرؤية احسن الأماكن المعروفة؟	ما هي أفضل جولة حتى أرى أشهر الأماكن ؟
لا، يا سيدي. بعد الظهر محجوز كله . لكن بكرة اوكي.	لا يا سيدي . هذه الظهيرة محجوزة بالكامل . ومع ذلك يمكن أن تحجز غدا .
أنا ح اسأل البواب على الأجرة الصحيحة.	سأذهب كي أسأل البواب عن الأجرة المناسبة .
انا حقيقة، آسف.	أنا حقا آسف .
طيب، غرفتك تسعة صفر تمنية، يا انسة. دا مفتاحك.	حسنا , حجرتك يا آنسة هي رقم تسعة صفر ثمانية . هذا مفتاحك .
اعزرني، ضابط؟	معذرة , ضابط ؟
هل القطر ده بمشي مباشرة إلى ادينبره؟	هل هذا القطار يتجه مباشرة إلى إدنبره ؟
هل دا ف الحد بتاع اعفاء الضرائب؟	هل يدخل هذا في حدود المعفي من الضرائب ؟
كيف الرحلات السياحية مزحومة؟	كيف يكون الزحام في مثل تلك الجولات ؟
داير اشتري بعض التذكارات. هل هناك اي متجر مناسب قريب هنا؟	أود أن أشتري بعض التذكارات . هل يوجد هنا محل مناسب ؟
مايومي، ممكن تملى الورقة دي بتوقيعك؟	مايومي , هل تسمح أن تملأ هذه الورقة بتوقيعك ؟
هنا واحد ليك، سيدي.	إليك إحداها يا سيدي .
ما عندي عفش للتسجيل.	ليس لدي أمتعة للتفتيش .
انا هنا في مهمة وسائط الإعلام.	أنا هنا في مهمة إعلامية .
متين القطر التالي إلى واشنطن دي سي؟	متى يأتي القطار التالي المتجه إلى واشنطن العاصمة ؟
ح أكون راجع لليابان الاتنين الجاي.	سأعود إلى اليابان الاثنين المقبل .
ممكن احصل على خريطة النفق؟	هل يمكنني الحصول على خريطة للمترو ؟
هل هي رحلة طويلة؟	هل هو طريق طويل ؟
هل يمكنك تبدل دا لواحد جديد؟	هل يمكنك تبديل هذه بواحدة جديدة ؟
نفرين.	شخصان .
أنا ما حاسي كويس . ممكن اتكي المقعد؟	لا أشعر براحة . هل يمكنني حني مقعدي ؟
ممكن توريني كافيتريا شعبية بين الناس الشباب؟	هلا أرشدتني إلى مطعم مفضل بين الشبان ؟
عربيته كانت جارية بالسرعة الكاملة.	كانت سيارته تسير بكامل سرعتها .
هل داك صحيح؟ خليني أراجع. اوه، انا آسف جدا، انسة تاكانو. دي غلطتنا. هي فاتورتك الجديدة. توقعي هنا، من فضلك؟	هل هذا صواب ؟ دعني أتحقق . أوه ، أسف بشدة آنسة تاكاناو . هذا خطأنا . إليك فاتورتك الجديدة . هلا تفضلت بالتوقيع هنا ، من فضلك ؟
رجع خمسة دولارات، من فضلك.	الباقي خمسة دولارات ، من فضلك .
سداد البانيو ما بتقفل بشكل كامل.	سدادة حوض الاستحمام لا تقفل بالكامل .
هو فقط رمز لتقديري.	إنها مجرد هدية تعبيرا عن تقديري .
هل ح تملى الفورمة دي؟	هلا ملأت هذا النموذج ؟
ياتو أصناف عندك؟	ما هي الماركات التي توجد لديك ؟
الكعوب عالية جدا لي.	الكعب عالي جدا بالنسبة لي .
ممكن احصل على طابعات بريد لتلاتة بطاقات بريدية لبريد جوي؟	هل يمكنني الحصول على طوابع بريدية لثلاث بطاقات بريدية جوية لليابان ؟
بيتهجي ج-و-ر-و-ه.	تتهجي جي أوه آر أوه اتش .
داير تاخد مشروب؟	هل تبغي شراباً ؟
حسب تقرير الطقس، ح تثلج بكرة.	طبقاً لتقرير الطقس ، فإن غداً سيشهد سقوط جليد .
بالتأكيد، ح نكون سعيدين نعمل داك.	بكل تأكيد . سنكون سعداء لفعل هذا .
هي، كتاب هزلي ماليزي. ح اشتري واحد عشان اشيله البيت كقطعة محادثة.	هاي ، كتاب كوميدي ماليزي . سأشتري واحداً لآخذه إلى المنزل كقطعة محادثة .
"الطريق للنجاح هو ""جنمياكو""، صاح؟"	"الطريق إلى النجاح هو "" جينمياكو "" حقاً ؟"
عندي حوالي ألفين و خمسمية دولار بالين الياباني.	يوجد لدى حوالي ألفي وخمسمائة دولار بالين الياباني .
نعم، نفعل. ح أوريك بعضه.	نعم ، نحن تفعل . سأريك بعضاً .
داير بعض حبوب نوم.	أبغي بعض الأقراص المنومة .
ح أكون هنا لحد التاسع. بأمل انك تقبض المجرمين بسرعة قدر الإمكان.	سأكون هنا حتى التاسعة . يحدوني الأمل أن تتمكن من القبض على المجرم في أقرب وقت ممكن .
انا متأكد المجرم قريب.	إنني على يقين أن المجرم قريب .
عشرة طابعات من فضلك.	عشرة طوابع من فضلك .
حصلت على قرحة حلق.	أصبت بالتهاب في الحلق .
أنا محتاج لبعض التذكارات من نيو يورك.	احتاج إلى بعض الهدايا التذكارية من نيويورك .
ساعتي وقفت.	توقفت ساعتي .
أوه، دا هو؟ كيف بتحبه؟	أوه ، أهي كذلك ؟ كيف تفضلها ؟
نحن فاتحين الساعة تسعة صباحا.	نحن نفتح في التاسعة صباحاً .
داير كتاب تلوين.	أريد كتاب تلوين .
اظن اني حاسي بدوار الجو.	أظن أنني مصاب بدوار الجو جواً .
هل على أن أمشي لبنك ياباني؟	هل يجب أن أذهب على بنك ياباني ؟
مفروض تحول القروش في البنك.	يجب أن تغير النقود من البنك .
هل في زمن كافي للخروج؟	هل لدينا وقت كاف لإنهاء إجراءات المغادرة ؟
زوجك واحد من أحسن عملائنا.	زوجك أحد أفضل عملائنا .
هل بتعرف دكتور أسنان كويس؟	هل تعرف طبيب أسنان جيد ؟
اوه. انت مفروض تنبه القنصلية الآن.	أوه ، يجب أن تخطر القنصلية على الفور .
مهزوز، ما محرك.	مهزوز ، وليس مضروب .
عدد كبير من الناس بيمشوا للشاطئ خلال الموسم.	يذهب عدد كبير من الناس إلى الشاطئ خلال الموسم .
انا بوزن حوالي مئة و خمسين رطل.	وزني حوالي مائة وخمسين رطلاً .
وين مفروض احول؟	إلى أين يجب علي أن أنقل ؟
هل هناك أي بص بمشي هناك مباشرة؟	هل هناك حافلة تذهب مباشرة إلى هناك ؟
هل انا محتاج لأي معاملة خاصة؟	هل أحتاج لعلاج خاص ؟
داك ح يكون كاش ول شحن؟	هل سأدفع نقداً أم يضاف على الفاتورة ؟
كم من الزمن ح ياخد عشان احصل على فيزتي؟	كم سيستغرق إصدار التأشيرة لي ؟
وين الحمامات؟	أين غرف الراحة ؟
القيمة الكلية المستحقة متين و تلاتة وأربعين جنيه، يا مدام.	إجمالي المبلغ المطلوب مائتان وثلاثة وأربعون جنيه ، يا سيدتي .
دي هدية. ممكن تلفها في بعض ورق اللف الجميل؟	هذه هدية ، هل يمكن أن تلفها لي في ورق لف جميل ؟
ما اعظمه من منظر. ديل آثار عظيمة.	ياله من منظر . إنها مسالك رائعة الجمال .
اعزرني، لكن انا داير أمشي لفندقي في المدينة بالبص. وين ممكن اخد بص؟	معذرة أريد الذهاب إلى فندقي في المدينة بالحافلة . أين يمكن أن أستقل حافلة ؟
ثم خلينا نخت حشوة جوة.	إذن دعنا نبطنها من الداخل .
ممكن تقوله بي كلمات تانية؟	هل يمكن أن تقول لي ذلك بعبارة أخرى ؟
ح اعمل بمهما يكون عندك.	سوف استخدم ما يوجد عندكم .
دايرين طربيزة جنب المنصة.	نريد مائدة بالقرب من المسرح .
انا تمام. طيب، انت ماشى محل؟	أنا بحالة جيدة . حسنا , هل أنت ذاهب إلى مكان ما ؟
أدخل. من فضلك خته في الطربيزة هنا.	ادخل . من فضلك ضعها على المائدة هناك .
انا آسف، كلهم اتباعوا، لكن ح يكونوا عندنا في أيام قليلة.	آسف لقد نفدت ، لكن سوف تردنا بعد بضعة أيام .
ما عندي موعد، لكنه مستعجل.	ليس لدي موعد ، لكن الأمر عاجل .
دا مصنوع بشكل سئ.	إنه رديء الصنع .
وين المصعد؟	أين المصعد ؟
هل عندك دليل مناسبات؟	هل لديكم كتيب حول العروض ؟
وين المدخل للنفق؟	أين مدخل مترو الأنفاق ؟
أنا فقدت تزكرتي الجوية.	لقد أضعت تذكرة الطيران الخاصة بي .
ما بتقدر تقعد هنا خلال العطلة؟	ألا تستطيع البقاء هنا خلال الإجازة ؟
المجموع كم؟	ما هو الإجمالي ؟
داك جيد جا. الآن للأسئلة، من فضلك.	هذا جيد للغاية . والآن الأسئلة ، من فضلك .
هل عندك اي فكة لعداد الباركنق؟	هل لديك أية فكة لعداد الانتظار ؟
ألف على الشمال؟	هل انعطف يساراً ؟
سعر رايع، ول لا؟	سعر رائع ، أليس كذلك ؟
لازم تاخده تسعة وتسعين مرة في اليوم، قبل الوجبة.	لابد أن تأخذها تسعة وتسعون مرة في اليوم ، قبل الوجبات .
انا أحبه.	أحبه فعلاً .
داير ترايبود.	أريد حامل ثلاثي .
عظيم. كنت بفتش لتاكسي، لكن دا أحسن.	عظيم . كنت أبحث عن سيارة أجرة لكن هذا أفضل .
داير أمشي لمركز هارفارد. ممكن تكلمني لمن نصل هناك؟	أريد الذهاب إلى مركز هارفارد . هل يمكن أن تخبرني عندما نصل إلى هناك ؟
اتنين بالغين و طفلين، من فضلك.	بالغان وطفلان ، من فضلك .
السعر كم؟	ما هو السعر ؟
حرب النجوم حقق أعظم نجاح في ألف تسعمية أربعة وتمانين.	"كان فيلم "" حرب الكواكب "" أكثر الأعمال شعبية عام ألف وتسعمائة وأربعة وثمانون ."
وين قطاع غير المدخنين؟	أين قسم غير المدخنين ؟
"ديك ""ت"" زي ال في توم، نعم عندي منها هنا، يا تارو."	"حرف "" ت "" "" كما في توم ، نعم ها هي لدي هنا ، تارو ."
هو لشنو؟	ما فائدة هذا ؟
أي كردت كارد بتقبل؟	أي بطاقات ائتمانية تقبلون ؟
عندي كتير من الزمن.	عندي الكثير من الوقت .
طيب، إنه زمن الغداء. داير تناقشه خلال الغداء؟	حسنا ، إنه وقت الغداء . هل تحب أن نناقشه على الغداء ؟
الو، اسمي اودا. عندي حجز لليلة، لكن ح أكون متأخر شوية في الدخول. عشان كدا احفظ حجزي.	ألو ، اسمي أودا . عندي حجز الليلة ، لكن سوف أتأخر في القدوم . لهذا من فضلك اتركوا لي الحجز .
هم بقولوا الأنفلونزا سائدة هناك.	يقولون إن الأنفلونزا منتشرة هناك .
جوة.	لقد جاء لتوه .
انا مع بعض الأصحاب.	أنا مع بعض الأصدقاء .
طبقا لجورو، مستر يامادا عنده طفلين.	حسبما يقول جورو ، فاللسيد يامادا طفلان .
داير اعمل التفاف إلى برج لندن.	أريد أن أعرج على برج لندن .
من فضلك اربط حزام مقعدك.	من فضلكم . اربطوا الأحزمة .
إنه تعبان.	إنها مشغولة .
هل عندك طعام بحري؟	هل لديكم طعام بحري ؟
داك غالي شديد.	هذا مكلف نوعا ما .
داير، لكن آسف ما بقدر اعمله في الزمن دا.	أود ذلك ، لكنني أخشى ألا أستطيع هذه المرة .
طيب، ما عارف لسة، لكن اكيد ح أحاول.	حسنا ، لا أعلم بعد لكنني سوف أحاول بالتأكيد .
من فضلك استعمل غرفة القياس هناك.	من فضلك استعمل غرفة القياس هناك .
كيف الوالدين اليابانيين بربو أطفالهم؟ هل هم صارمين مع أطفالهم؟	كيف يربي الآباء اليابانيون أولادهم ؟ هل هم صارمون مع أطفالهم ؟
ممكن توريني ساعات العمل؟	هل يمكن أن تخبرني عن ساعات العمل ؟
ممكن نبدأ اللعب لم ينتهوا؟	هل يمكن أن نبدأ اللعب عندما ينتهون ؟
سكان اليابان حوالي مية و عشرين مليون.	تعداد سكان اليابان حوالي مائة وعشرينا مليونا .
املأ العناصر التالية في بطاقة التسجيل.	املأ البنود الآتية في بطاقة التسجيل .
ممكن أسترجع حاجاتي؟	هل يمكن أن أستعيد متعلقات ؟
هل عندك اوشحة حريرية؟ انا بفتش لهدية لزوجتي.	هل لديكم أوشحة حريرية ؟ إنني أبحث عن هدية لزوجتي .
ح نجيبه أسي. كم رقم غرفتك؟	سوف نحضرها الآن . ما هو رقم غرفتك ؟
داير أسافر من شانغهاي إلى هاواي بالسفينة.	أريد السفر من شنغهاي إلى هاواي بالباخرة .
بياخد عشرة دقايق بالارجل.	إنها تستغرق عشر دقائق سيراً على الأقدام .
قبل ما نسميه يوم، ممكن تديني بعض الدقايق؟	قبل أن ننهي العمل ، هلا أعطيتني بضعة دقائق ؟
سكوتش و موية، من فضلك. و هل عندك اي وجبة خفيفة؟	ويسكي وماء ، من فضلك . هل لديكم وجبة خفيفة معه ؟
كيف ممكن أطفي الإضاءة دي؟	كيف يمكنني أن أطفأ الضوء ؟
هل هو مشغول جدا اليوم؟	هل هو مشغول جدا اليوم ؟
داير خيط.	أريد بعض الخيط .
اديني شهادة طبية، من فضلك.	اعطني شهادة طبية , من فضلك .
دايرك تعمله أقل بواحد انش هنا.	أود تقصيره ببوصة واحدة من هذه المنطقة .
انا ما حاسي كويس. من فضلك اديني بعض الدواء.	لا أشعر أنني على ما يرام . من فضلك اعطني بعض الدواء .
هل هناك اي اكسبريس لبوسطن؟	هل يوجد أي قطار سريع إلى بوسطن ؟
أنا متحمس جدا. ما قادر اكون قاعد.	أنا متأثر للغاية , لا أستطيع البقاء ساكنا .
ممكن انزل في فندق الهيلتون؟	هل يمكن أن أنزل عند فندق هيلتون ؟
دايرك تزحه.	أريدك تنزعه .
أمشي شمال بالشارع دا و اخد أول يمين.	اتجه يساراً في هذا الشارع ثم انعطف عند أول منعطف يمين .
داير أعرف إذا ممكن احصل على الطقم دا من الصحون مشحون لطوكيو.	أريد أن أعرف إذا كان يمكن شحن مجموعة الأطباق هذه إلى طوكيو .
هل هناك أي طعام ما حار شديد و سبايسي؟	ألا يوجد طعام متبل وليس حارا جدا ؟
هل هو قريب كفاية للمشي؟	هل هو قريب لنصل إليه سيراً .
ممكن تمرر لي الملح؟	هل يمكن أن تمرر لي الملح ؟
داير أمشي لى وول استريت. كيف اوصل هناك؟	أريد الذهاب إلى وول ستريت . كيف أصل إلى هناك ؟
تمارين كتيرة شديد ح تاذيك.	الكثير جداً من التمارين يضر بك .
متضمن الفطور، ضرائب، و رسوم خدمة، ح تكون خمسة وأربعين دولار للنفر الواحد.	بما في ذلك الإفطار ، والضريبة ، ورسم الخدمة ، سيكون الحساب خمسة أربعون دولارا للشخص الواحد في الليلة .
مساء الخير . اهلا.	مساء الخير . أهلا .
ما قادر ألقى عفشك.	لا أستطيع العثور على أمتعتك .
هل الموية هنا صالحة للشرب؟	هل من المأمون شرب الماء الذي هنا ؟
اااه، ياللا. دولارين فقط.	أهه ، هيا . دولارين فقط .
طيب، خلينا نمشي. ممكن اساعدك في واجبك المنزلي بعد ناخد بعض البيتزا.	حسنا ، هيا نذهب . أستطيع مساعدتك في واجبك المنزلي بعد أن نتناول بعض البيتزا .
نعم، مستر. تاناكا. هناك في رسالتين ليك.	نعم ، يا سيد تاناكا هناك رسالتان لك .
ما بناسبني.	إنه لا يلائمني .
بكرة يوم آخر.	الغد يوم آخر .
محفظتي إتنشلت في القطر.	إن محفظتي نشلت في القطار .
هو بعيد جدا. أحسن تاخد تكسي.	إنه بعيد جداً . يحسن بك أن تأخذ سيارة أجرة .
داير مقعد ممر، من فضلك.	أريد مقعداً يطل على الممر ، من فضلك .
ساكن في شقة بتمنين ألف ين في الشهر.	أعيش في شقة إيجارها ثمانون ألف ين في الشهر .
ممكن أقاطع؟	هل لي أن أقاطعكم ؟
اعزرني. ممكن تبدل المقاعد معاي؟	معذرة . هل تمانع في أن تبادل المقاعد معي ؟
نعم، طبعا.	نعم ، بالطبع .
أمشي للكورنة و لف شمال عند الإشارة.	اذهب إلى الناحية وانعطف يساراً عند إشارة المرور .
نعم، بس أتأكد ان عندك تزكرتك معاك.	نعم ، ولكن تأكد أن تذكرتك معك .
فقط ناس بسيطين ح ينضموا للجولة الاختيارية.	لن ينضم للجولة الاختيارية إلا القليل من الناس .
ناس جداد اتعينوا في أبريل.	تشغل أشخاصاً جدد في أبريل .
أتمنى ذلك.	أرجو ذلك .
اتنين سكوتش و موية، من فضلك.	اثنان ويسكي مع الماء , من فضلك .
من اللاعب؟	من الذي يعزف ؟
للشمال، من فضلك.	إلى اليسار ، من فضلك .
السن دي الفي الأمام بتوجع.	هذه السن في المقدمة تؤلمني .
ما هي آخر لعبة كمبيوتر لعمر خمستاشر سنة؟	ما هي أحدث ألعاب الكمبيوتر لفتى سنه خمسة عشر عاما ؟
ح نشوفك بكرة.	سنراك في الغد .
لا، لكن شكرا. انا حاسي أحسن.	لا ، ولكن شكراً لك . إنني أشعر بتحسن .
هل عندك اي عيش؟	هل لديكم أي خبز ؟
كيف اجادتك للكمان؟	ما هو مستوى مهارتك في عزف الكمان ؟
صحبي اتزلق و وقع في الحمام.	لقد انزلقت قدما صديقي وسقط في الحمام .
ممكن اخد طفاية؟	أريد مطفأة سجائر .
المسيحية كانت محظورة و البلد كانت مقفولة من باقي العالم.	حظرت المسيحية وأغلقت البلاد بالنسبة لبقية العالم .
داير كم انت؟	ما الكمية التي تريدها ؟
كوكتيل جمبري ليها و نفس الشي لي أنا.	خلطة جمبري لها ، وكذلك لي .
ممكن اخليك توقع هنا؟ و من فضلك بداية هنا.	هلاّ جعلت توقيعك هنا والحروف الأولى من اسمك هنا .
إنها سعادة عظيمة لي أن أزور مكاتبك الرئيسية و احصل علي نقاش كبير معاك. شكرا ليك كتير لتعاونك الطيب.	لقد أثلج صدري زيارة مقاركم الرئيسية وكذا ما جرى بيننا من مناقشات مهمة . شكراً جزيلاً على ما أبديتموه من تعاون .
شخيرك مزعج.	إن غطيطك مزعج .
ما بحب اللون بعد دا كله. ممكن أرجع دا؟	إن لونها لا يروقني على الإطلاق . هلي يمكنني إرجاعها ؟
ممكن احصل على بعض الفلفل؟	هل لي في بعض الفلفل ؟
معاك مستر تاكاباشي في غرفة خمسة تسعة وأربعين. ممكن ترسل أربعة قارورات من بيرة براوزر، من فضلك؟	أنا السيد تكاهاشي بالغرفة رقم خمسة تسعة وأربعين . من فضلك أرسل أربع زجاجات من بيرة بودفايزر .
داير مكالمة إيقاظ عند تمنية و تلاتين صباحا، من فضلك.	أريد مكالمة لإيقاظي في الثامنة والصف صباح غد ، من فضلك .
أيوة، لكن دا كتير شديد و انا اساسا ملان.	أجل ، ولكن هذا كثير جدا ، ولقد شبعت بالفعل .
داير بعض غسول الفم.	أريد غسيلاً للفم .
ما حاسي تمام.	أشعر بوعكة .
ممكن تساعدني القي حديقة الحيوان؟	فضلا ، ساعدني في العثور على حديقة الحيوان .
ح توريني اضبطوا كيف؟	هلا أخبرتني كيفية تعديلها من فضلك ؟
هل تعرف كيف تستخدم تلفون؟	أرني كيفية استعمال الهاتف .
اكيد. عندنا بعض علامات الكتب أمريكية اصلية جميلة.	بالتأكيد . لدينا بعض الماركات الأمريكية الأصلية الجميلة . للكتب .
مشغل مكالمات يتكلم ياباني، من فضلك.	أريد عامل تشغيل يتحدث اليابانية من فضلك .
نحن مهتمين بالموضة.	نحن مهتمون بالأزياء .
ممكن تديني مقطورة؟	هل يمكنك أن تجر سيارتي ؟
اهلا، انسة ياماقوشي؟ الطرف التاني في الخط. مكالمتك اتقبلت. اتفضلي، من فضلك.	مرحبا يا سيدة ياماجوتشي ؟ فريقك على الخط . قبلت دعوتك . استمر من فضلك .
ياتو زمن ح نصل في لوس أنجلوس؟	متى نصل إلى لوس أنجلوس ؟
أمشي دغري لحوالي خمسة دقائق، و لف شمال.	سر في نفس الاتجاه حوالي خمس دقائق ثم لف لجهة اليسار .
هو الشارع دا تجاه الشاطئ.	إنه في هذا الطريق في اتجاه الشاطئ .
الشاي العشبي دا بساعد في تجديد الجسم.	هذا الشاي العشبي يساعد الجسم على استعادة نشاطه .
دي ما مصنوعة في اليابان، ول لا؟	لم تصنع هذه باليابان ، أليس كذلك ؟
كله تمام. الشارع دا من فضلك. ح اوديك لغرفتك.	حسناً . خذ هذا الاتجاه . من فضلك ، سأوصلك إلى غرفتك .
اتنين هامبرقر و قهوتين، من فضلك. داير اشيلهم برة.	نريد اثنين هامبورجر واثنين قهوة ، من فضلك ، نريد تناولها خارج المحل .
ممكن أشيل الشنط دي؟	هل يسعني أن استمر في حمل هاتين الحقيبتين ؟
طلبت لحم، ما سمك. ممكن تغير دا؟	لقد طلبت لحما لا سمكا . هل يمكنك تغيير هذا ؟
أنا مريض للمعدة.	أشعر بالغثيان .
ممكن احصل علي إعادة المبلغ لم أرجع لليابان؟	هل سأسترد ما أنفقت عند عودتي إلى اليابان ؟
الصحن دا مصنوع من شنو؟	ما هي مكونات هذا الطبق ؟
أي بلد مصنوع فيها دا؟	في أي الدول صنعت هذه .
ممكن تعمله في عشرة دقائق؟	أيمكنك الانتهاء من ذلك بعد عشر دقائق ؟
وين ممكن احصل علي رمز النفق؟	من أني يمكنني الحصول على مسكوكة لركوب المترو ؟
ما أظن أن داك لي لأن بشرتي جافة شديد.	لا أعتقد أن ذلك يناسبني فجلدي جاف إلى حد ما .
ممكن احصل على جدول زمني، من فضلك؟	أيمكنني الحصول على جدول زمني ، من فضلك ؟
تسعة وتسعين دولار للساعة للطفل.	تسعة وتسعون دولاراً في الساعة للطفل ؟
أنا آسف، نحن بعنا.	آسف لقد نفذ هذا الصنف لدينا .
لازم يكون هادئ.	لابد أن تكون هادئة .
مفتاح غرفة، خمسة صفر تلاتة، من فضلك.	أريد مفتاح الغرفة خمسة صفر ثلاثة ، من فضلك .
عند الساعة سبعة، من فضلك.	في الساعة السابعة ، من فضلك .
شنطتي اتدمرت.	لقد أتلفت حقيبتي .
سياحة.	لمشاهدة المعالم .
انا جيت من اسبانيا.	إني من إسبانيا .
ناس ودودين جدا.	إن الناس ودودون جداً .
وين باب الإيواء للرحلة دي؟	أين بوابة ركوب الطائرة بالنسبة لهذه الرحلة ؟
نحن في ارتفاع اتناشر ألف قدم.	إننا على ارتفاع اثني عشر ألف قدم .
أولا، دايرين نشوف وول استريت.	في البداية نود مشاهدة وول ستريت .
وين موقف البص لاكسفورد؟	أين محطة الحافلة التي تقصد أكسفورد ؟
ح انتظر لغاية الشرفة تكون متاحة.	سأنتظر حتى يتاح الجلوس في التراس .
ممكن نشوف بعض المحافظ جلدية؟	هل يمكننا أن نلقي نظرة على حافظات جلدية ؟
ممكن تكتب عنوانك هنا؟	هل يمكنك كتابة عنوانك في هذا المكان ؟
من فضلك وريني وين أقرب صيدلية.	أخبرني من فضلك أين أقرب صيدلية .
لفندقي، من فضلك. عنوان فندقي هنا.	إلى فندقي ، من فضلك ، إن عنوان فندقي في هذه الورقة .
علق و انتظر لفترة من فضلك.	ابقى على الخط وانتظر لحظة من فضلك .
انت عادة بتعمل شنو في البيت بعد العشاء؟	ماذا تعمل في المعتاد بالمنزل بعد تناول العشاء ؟
بالتأكيد. متين داير تلعب قولف؟	بالتأكيد . متى تود أن تلعب جولف ؟
هي ح تكون في البيت حوالي تلاتة.	ستكون بالبيت في حوالي الثلاثة .
داير اتصل بالسفارة اليابانية.	أريد أن اتصل هاتفياً بالسفارة اليابانية .
زيادة شوية.	زدني قليلاً .
كم بتشحن لارسالهم لليابان؟	كم تتقاضى ثمنا لإرسالها لليابان ؟
هل الين الياباني تمام؟	هل تقبل بالين الياباني ؟
نحن ح ننط من هنا؟	هل سنقفز من هنا ؟
مستر كاواي، عندنا طربيزة ليك الآن. تعال من هنا، من فضلك.	يا سيد كاواي لدينا مائدة لك الآن . تفضل من هنا .
بالتأكيد. أمشي بالسلالم تحت هناك و ح تشوف بعض التعليمات. بس تابعهم.	بالتأكيد ، انزل من على الدرج هناك وسوف تجد بعض الإرشادات فاتبعها من فضلك .
ممكن تنزلني في فندق الهلتون، من فضلك؟	هلا أنزلتني عند فندق هلتون من فضلك ؟
طربيزة لغير المدخنين، من فضلك.	مائة غير المدخنين من فضلك .
اتهجاه، من فضلك.	تهجى الكلمة من فضلك ؟
أنا أصبحت سكران بالخمرة.	بدأت الخمر تثملني .
خلي بالك لأن الجو متغير شديد في الجبال.	احترس لأن الجو في الجبال شديد التقلب .
شيك سياحي و ين ياباني، اوكي؟	هل يمكن استخدام شيكات سياحية وعملة ين ياباني ؟
آسف، انا اتحققت من خدمة الغرف وقسم المفقودات. ما موجود عندهم.	آسف ، لقد تحققت من إدارة الخدمة وإدارة المفقودات ولم أجدها عندهم .
انه مكان صعب لايجاده. إنه في طريق سريع في مين هايوي.	يصعب العثور على هذا المكان . إنه في طريق ضيق يتفرع من الطريق الرئيسي .
ما بعرف شي عنه.	لا أعرف شيئاً عن هذا الأمر .
ممكن نناقشه في مقهى.	يمكن أن نتحدث حول هذا الموضوع في مقهى .
شايف، في الحالة ديك انا ما على دفع سعر التعديلات، صاح؟	فهمت ، في هذه الحالة ليس علىّ أن أدفع أجر التبديلات ، أليس كذلك ؟
مشغل المكالمات، من فضلك.	اعطني عامل التليفون من فضلك .
ممكن توطي السرج، من فضلك؟	هل يمكن أن تنزل السرج ، من فضلك ؟
أوكي. ح اخد فقط دقيقتين. شكرا ليك.	حسناً . سوف أخذ اثنين فقط . شكراً .
انت محظوظ.	أنت محظوظ .
من فضلك خليها طربيزة مع منظر ليلى جيد.	من فضلك اختر لي مائدة ذات منظر ليلي لطيف .
هل دا صنع آلي ول صنع يدوي؟	هل هذا مصنوع آليا أم يدويا ؟
إنه ممزق.	إنه ممزق .
طب، ب س فكر كم من الزمن شغله ح ياخد لو هو سأل سؤال واحد إضافي لكل شخص. ياللا، خلينا نسرع و نحصل على عفشنا. ومفروض نمشي لاجراءات الجمارك.	حسنا ، تصور كيف ستطول فترة عمله لو سأل سؤالاً آخر لكل شخص . هيا بنا ، لنسرع ونحضر حقائبنا . علينا الذهاب إلى الجمارك للإعلان عن أغراضنا بعد ذلك .
الوزن كم؟	ما هو الوزن ؟
رصيف خمسة هناك.	إن الرصيف رقم خمسة يقع هناك .
متين ح تبدأ لعبة السوكر؟	متى تقام مباراة كرة القدم ؟
أعتقد أنه في بعض الأخطاء في الفاتورة.	أعتقد أن هناك أخطاءً في الفاتورة .
من فضلك أديني الواحد داك.	من فضلك اعطني هذه .
هل انت اسكتلندي؟	هل أنت اسكتلندي ؟
فساتين قصيرة مع بوت ما ح تطلع برة الموضة أبدا.	إن الجونلات القصيرة ومعها الأحذية الطويلة لن تنقضي موضتها .
لي اجرتك مخالفة للعداد؟	لماذا يختلف السعر عن الموجود في العداد ؟
ممكن اشوف الواحد دا؟	هل يمكن أن أرى هذا ؟
الطرف التاني في الخط. اتفضل.	حفلتك مقامة الآن . تفضل .
هل هناك عرض طابق؟	هل هناك عرض ترفيهي ليلي ؟
اخد الدواء دا بعد كل وجبة لمن يوجع شديد.	خذ هذا الدواء بعد كل وجبة عندما يزداد الألم .
انت بتخت القروش في ظرف خاص مزخرف البسموه شوقيبوكورو.	لقد وضعت المال في مظروف خاص مزين يسمى شوجيبوكورو .
في زول اتاذي.	لقد أصيب شخص .
هل عندك خريطة للمترو؟	هل لديك خريطة لمترو الأنفاق ؟
عندي غرفة جاهزة ليك في القراند هوتل. ممكن تمشي هناك؟	لدي غرفة جاهزة لك في جراند هويتل . هل تستطيع الذهاب إلى هناك ؟
عندي وجع في عيني اليمين.	عندي ألم في عيني اليمنى .
انا ما كويس جدا في الألماني.	لا أحسن الألمانية كثيراً .
نحن بالتأكيد مفروض نرجع سواء تاني.	لابد أن نجتمع ثانية بالتأكيد .
ممكن تضيق السروال دا؟	هلا أخذت هذه السراويل ؟
ممكن استعير مضارب و كورة؟	هل يمكنني استعارة مضرب وكرات ؟
ممكن احصل على نص دورق؟	هل يمكن أن أخذ نصف إبريق ؟
هاي. انا جن.	تحية . أنا جون .
ناكاي.	ناكاي .
هل تمانع إذا اخدت صورة ليك و لتكسيك؟	هل تمانع إذا التقطت صورة لك ولسيارتك الأجرة ؟
اتصلت عن شنطة ضايعة قبل تلاتة أيام.	لقد اتصلت منذ ثلاثة أيام بخصوص حقيبة ضائعة .
في العمل. عندي أتصال عمل هناك.	في عمل . لدي صلات عمل هناك .
ممكن من فضلك تخلي بالك لشنطتي؟	هلا راقبت حقيبتي من فضلك ؟
كيف بتحب الفكرة دي؟ نحن بنقبل ظرفك بتاع ستة شهور ملاحظة قدمت انك ضمنت لينا الحق للبيع لستة شهور بعد انتهاء العقد.	كيف تحب هذه الفكرة ؟ نحن نقبل بشرطك الذي ينص على فترة بلاغ مسبق قدرها ستة اشهر شريطة أن تمنحنا الحق بالبيع لمدة ستة أشهر بعد إنهاء العقد .
أعذرني. هل أنت بتعرف نيويورك كويس؟	معذرة . هل تعرف نيويورك جيدا ؟
داير أقابل جراح.	أود زيارة جراح .
داير اركب عربية رياضية.	أريد أن أركب في سيارة رياضية .
كود المنطقة صفر تلاتة. الرقم تلاتة واحد تلاتة أربعة خمسة ستة سبعة.	كود المنطقة هو صفر ثلاثة . والرقم هو ثلاثة واحد اثنان ثلاثة أربعة خمسة ستة سبعة .
هو عانى من نزلة.	لقد أصيب ببرد .
داير أرسل التسليم العام دا.	أريد أن أرسل ذلك بطريقة التوصيل العام .
خليني احول المكالمة دي للزول المسؤول.	دعني أحول هذه المكالمة إلى المسئول .
ياتو مقاس انت داير؟	أي مقاس تريد ؟
اوه، عزيزي. ما لاحظت اني ما زلت عندي ديلك.	أوه يا عزيزي . لم أدرك أنني لازلت لدي هذه الأشياء .
هل عندك صناديق لحزم الارسال؟	هل ليدكم صناديق لإرسال الطرود ؟
هل الخطوط الجوية ح تدفع لفندقي و تكاليف الوجبة؟	هل ستدفع شركة الطيران رسوم الفندق والوجبات ؟
كيف تتمني تعمل المكالمة؟	كيف ترغب في إجراء المكالمة ؟
ممكن من فضلك تمرر لي الملح؟	هلا مررت لي الملح ، من فضلك ؟
وين أقرب كافيتريا من الفندق دا؟	أين أقرب مطعم لهذا الفندق ؟
متين بتعتقد ح يتلقي؟	متى تعتقد سيتم إيجادها ؟
ح يكون عندي اسبرايت كبير.	سوف أتناول زجاجة سبرايت كبيرة .
أعذرني. داير أضع طلب.	معذرة . أريد أن أطلب طلب .
داير غرفة لمنظر جميل.	أريد غرفة بمنظر جميل .
تلاتة قزازات بتاعت عصير بطيخ، من فضلك.	ثلاثة أقداح من عصير الشمام ، من فضلك .
عندي تلاتة أطفال.	عندي ثلاثة أطفال .
أمشي دغري بالهول دا و لف شمال في الكورنة. ح تشوفه في يمينك.	سر للأمام إلى آخر هذه القاعة وانعطف يسارا عند الركن . سوف تجدها على يمينك .
بمشي لنادي رياضي كل يومين.	اذهب إلى نادي رياضي كل يومين .
وين ممكن اقعد خلال الجولة؟	أين يمكنني أن أقيم أثناء الجولة ؟
متين زمن الخروج؟	ما توقيت إجراءات مغادرة الفندق ؟
كم رسوم المرشد لليوم؟	كم يتقاضى المرشد في اليوم ؟
وين ممكن ألقى سيديهات؟	أين أجد الاسطوانات المدمجة ؟
أعذرني. انا طالب كلية من اليابان. هل أنت طالب ان واي يو؟	معذرة . أنا طالب جامعي من اليابان . هل أنتم طلاب في جامعة نيويورك ؟
ممكن تورينا كيف انت قيمت الفكرة دي؟	هل من الممكن أن تخبرنا كيف تقيم هذه الخطة ؟
كاش ول شحن؟	نقدا أم ببطاقة الائتمان ؟
شغال لشركة تجارية.	أعمل في شركة تجارية .
دا عدم تهذيب تسأل الناس بجنوا كم.	ليس من الأدب أن تسأل الناس كم يتقاضون .
هل ديل واحدات ليفايس خمسمية وواحد اصليات؟	هل هذه من نوع ليفي خمسة صفر المعتمدة ؟
ياتو زمن ممكن اخد حمام؟	متى يمكنني أن آخذ حماما ؟
أنا شايف. حقيقة، عنده فلم سرعة عالية فيه. هل تمانع إذا طلعتوا؟	أفهم . في الواقع إنه به فيلم عالي السرعة . هل تمانع إذا أخرجته ؟
اشتريته قبل شوية.	اشتراها الآن فقط .
ح اجيب واحد الآن.	سوف أحضر واحدة في الحال .
من فضلك وريه مع المشتريات للجمارك في المطار.	من فضلك أظهرها مع المشتريات في الجمارك في المطار .
مشغل المكالمات، اديني محطة الاطفاء.	يا عامل الاتصال ، وصلني بمحطة الإطفاء .
عندي بطارية ميتة.	لقد حصلت على بطارية فارغة .
اقيف في التقاطع الجاي.	توقف عند التقاطع القادم .
اوه، هندا ليه. و هل على اي واحد يملأ فورمة تصريح الجمارك دي؟	آه ، ها هي . هل ينبغي على كل شخص أن يملأ استمارة الإقرار الجمركي هذه ؟
و ممكن اشيل اسمك من فضلك؟	ممكن أعرف اسمك من فضلك ؟
هل تمانع إذا عملت مكالمة على حساب الطرف التاني؟	هل من الممكن إجراء اتصال على أن يتم تحصيل أجرته من الطرف الآخر ؟
الو. كيف انت؟	مرحبا . كيف حالك ؟
وين قسم الترحيل؟	أين قسم السفر ؟
ما اسم الزول البتتمني تتكلم معاه؟	ما اسم الشخص الذي تود التحدث إليه ؟
شوف دا، شوف دا. انت ح تقولي الفرق بين الشاب دا و الشاب داك في الحظ؟ محمد، اقيف، ح تقيف؟ انت ما بتمانع إذا نزلتك هنا. أنا متأخر. صديق، جميل ان لاقيتك، اوكي؟	أنظر إلى هذا . انظر إلى هذا . سوف تخبرني أن الاختلاف بين هذا الشاب وذلك الشاب هو الحظ ؟ محمد ، يقف بالسيارة في جانب الطريق ، وأنت ؟ لن تمانع في أن أنام معك هنا . أنا متأخر . كان لقاء جميل معك ؟
أي رسائل لي؟	أية رسائل لي ؟
شكلك جميل.	تبدو جميلا .
هو على بعد تسعة وتسعين ميل.	إنها تبعد حوالي تسعة وتسعون ميلا .
فينس و ليندا دايرين يقعدوا براهم، عشان كدا آسف لازم اقعد هنا الليلة.	فينس وليندا يريدان أن يبقيا بمفرديهما ، لذا أخشى أنني لا بد أن أبقى هنا هذه الليلة .
اسمي ساتو.	اسمي ساتو .
أنا بعرف نادي جاز قديم وسط المدينة.	أعرف نادي قديم لموسيقى الجاز بوسط البلد .
ثم ح نشيله.	حينئذ سنأخذها .
هل دا بمشي فوق للسابق السادس؟	هل يصعد هذا إلى الدور السادس ؟
من فضلك خته في شنطة غسيل و خليه هناك.	من فضلك ضعه في كيس الغسيل و اتركه هناك .
داير الفلم دا يتطور. متين ح يكون جاهز؟	أود تحميض هذا الفيلم . متي سيكون جاهزا ؟
شباك تمام.	النافذة جيدة
خلي قصتي لتحت، لو سمحت.	اجعل قصة الشعر تتدلى لأسفل , من فضلك .
منزل ميتروبولتان اوبرا.	أوبرا ميتروبوليتان .
هو ما مذاقي.	هذا لا يناسب ذوقي .
متين بجي الدكتور؟	متي سيأتي الطبيب ؟
هو اللون الغلط.	انه اللون الخاطئ .
أنا في المشي.	أنا في نزهة طويلة سيرا على الأقدام .
وريني واحد لسيدة شابة.	أرني واحدة لإحدى الشابات .
ممكن تقيف هنا؟	هل يمكنك أن تتحرك بهذا الاتجاه ؟
انا عطشان.	أنا ظمآن .
لبن لا، من فضلك.	بدون حليب , من فضلك .
ممكن اخد مجلة ول حاجة؟	هل يمكن أن احصل على احدى المجلات أو شيئ من هذا القبيل ؟
إنه الجنوب.	انها باتجاه الجنوب .
كم سعر مقاعد البلكونة؟	ما تكلفة المقاعد الخاصة بالشرفة ؟
كله تمام. ح آخدك هناك.	و هو كذلك . سأوصلك إلى هناك .
الجزء المكتوب بميل يشير للتغييرات في تسعينات القرن العشرين.	الجزء المكتوب بالطريقة المائلة يشير إلى التغييرات التي حدثت في التسعينات .
داير أمشي لي الهارودس. ممكن ترسم خريطة، من فضلك؟	أود الذهاب إلى محل الهارودز . هل معك خريطة , من فضلك ؟
هل عندك بطاريات للكاميرا دي؟	هل لديك أحجار بطارية لهذه الكاميرا ؟
داير كيبل للتصوير عن بعد.	أود إرسال برقية لاسلكية .
أعتقد أنه محجوز زيادة.	أعتقد أن الحجز قد زاد عن العدد .
طلقة جيدة. بس برة.	ركلة موفقة . كادت تدرك الهدف .
ممكن توريني أماكن الاهتمام هنا؟	هل يمكن أن تخبرني عن الأماكن الشيقة هنا ؟
هل في أي متاجر شاملة قريبة من هنا؟	هل يوجد أي محل متعدد الأقسام قريب من هنا ؟
داير انضم من سان دييغو.	أود اللحاق بالسفر من سان دييجو .
كنت بفكر في اخد الكورس داك السمستر الجاي.	كنت أفكر في الحصول على هذه الدورة في فترة نصف العام المقبلة .
الخمرة ما باردة كفاية. ممكن تبردها اكتر؟	النبيذ ليس باردا بشكل كافي . هل نمكنك أن تجعله أكثر برودة ؟
شنو اكتر شي مهتم بيه الآن؟	ما هي أكثر الأشياء التي تثير اهتمامك الآن ؟
أنا احتمال ما اقدر ألقى مشروب زي دا في أي مكان تاني.	ربما لا يمكنني أن أتناول مثل هذا المشروب في أي مكان آخر .
إذا اشتريت دا برضه، ح يعمل القيمة المعفاة من الضرائب.	إذا اشتريت هذا أيضا , فستعمل للمبلغ الذي يعفي من الرسوم .
ممكن اشوف شهادة التطعيم حقتك، من فضلك؟	هل يمكنني أن أطلع على شهادة التطعيم الخاصة بك , من فضلك ؟
انا جاي من الولايات. المتحدة.	أنا من الولايات المتحدة .
عندي تزكرة جوية لسان فرانسيسكو.	معي تذكرة طيران إلى سان فرانسيسكو .
إذا هو فقط خمسين دقيقة من المحطة، ادا ح أمشي.	لو إن المسافة خمسة عشرة دقيقة فقط من المحطة ، إذن سأمشيها .
داير فندق أرخص شوية.	أريد فندق أرخص قليلاً .
ما داير انفق اكتر من عشرين دولار.	لا أريد إنفاق أكثر من عشرين دولاراً .
لي الرحلة ما بتقلع؟ وريني الحاصل شنو.	لماذا لم تقلع الرحلة ؟ أخبرني عما يجري .
دير أأجر كرسي سطح.	أريد استئجار كرسي مركب .
ما تهبشني.	لا تلمسني .
هل عندك سجائر؟	هل معك سجائر ؟
اذا الرياح ما قوية شديد، ممكن نمشي لتيكي بوينت.	يمكننا الذهاب إلى نقطة تيكي إذا لم تكن الريح قوية .
رائع.	رائع .
ح اقفل الآن. شكرا ليك لانتباهك.	سأغلق الآن . شكراً على انتباهكم .
اعزرني. ممكن توريني وين موقف التكسي؟	معذرة . هل لك أن تدلني على مكان موقف سيارات الأجرة ؟
و الشراب؟	وللشرب ؟ .
هندا ليه.	هاهي .
وين أقرب متجر أجهزة؟	أين يوجد أقرب متجر لأجهزة الكمبيوتر ؟
هممم. ما شغال، ول لا؟ ممكن تحركه لمقعد فاضي، إذا داير.	هه . إنها لا تعمل ، أليس كذلك ؟ يمكنك الانتقال إلى مقعد شاغر إذا كنت تريد ذلك .
كله تمام سيدي. و تحب شنو للتحلية؟	حسناً سيدي . وما الحلو الذي تريد أن تختم به الطعام ؟
عربة عادية ول بولمان؟	حافلة عادية أم حافلة مجهزة للنوم ؟
شيكات سياحية . شكرا ليك . دي تزكرتك و بطاقة ركوبك . كن هناك، من فضلك، قبل ساعة من زمن الرحلة.	شيكات سياحية . شكراً . خذ تذكرتك وبطاقة المرور للصعود على متن الطائرة . كن هناك قبل وقت الرحلة بساعة من فضلك .
الاسم جورو موتوياما. و الرقم صفر تلاتة تلاتة اتنين ستة واحد اتنين أربعة تسعة خمسة.	الاسم هو جورو موتوياما . والرقم هو صفر ثلاثة ثلاثة اثنان ستة واحد اثنان أربعة تسعة خمسة .
حاسس انى عيان جدا.	أشعر بمرض شديد .
وريني اسخن نادي ريقي في نيويورك.	دلني على أكثر نوادي موسيقى الريجاي إثارة في نيويورك .
هل اوكي ان مافي زول بسمع تعليمات الأمان؟	هل من المقبول عدم اتباع أي شخص لتعليمات الأمن ؟
هل طريق خلفي خطر؟	هل الشوارع الخلفية خطر ؟
نعم، من فضلك اخد الإجراء الضروري.	أجل . من فضلك اتخذ الإجراء الضروري .
نعم، واحد بس. متين ح اعرف؟ كيف ح أكون اتعوضت؟	أجل ، واحدة فقط . متى سأعرف ؟ وكيف سيتم تعويضي ؟
بنفضل طربيزة على الشباك.	نفضل مائدة بجوار النافذة .
من فضلك وريني الطريقة الارخص للمشي لسان فرانسيسكو.	من فضلك دلني على أرخص وسيلة للذهاب إلى سان فرانسيسكو .
اتجاه واحد.	اتجاه واحد .
أنا ح ابقى سمين بس قاعد هنا أكل باستمرار.	سأصبح بديناً في حال ما ظللت جالساً هنا آكل باستمرار .
هل هناك نادي ليلى جيد مع عرض فلامنجو؟	هل يوجد ملهى ليلي جيد به عرض رقصة الفلامنكو ؟
داك فستان جميل فيك.	جميل الفستان التي ترتدينه .
وين أقرب مغسلة؟	أين توجد أقرب مغسلة ؟
ممكن تبدل المقاعد معاي، من فضلك؟	هل لك أن نبدل مقاعدنا من فضلك ؟
مقاعدنا اتفصلت.	تم الفصل بين مقاعدنا .
بالتأكيد، داير احصل علي الحزمة دي مأمنة برضه.	في الواقع أريد استصدار صك تأمين على هذا الطرد أيضاً .
الفاتورة تجي مية دولار.	وصلت الفاتورة لمائة دولار .
كلوا تمام، حجزك تم إعادة تأكيده.	حسناً ، تم إعادة التأكيد على حجزك .
دايرين طربيزة في الشرفة.	نريد مائدة في الشرفة .
كيف داير القروش؟ من فضلك املأ الورقة دي و وقع هنا.	كيف تريد النقود ؟ من فضلك املأ هذه الورقة ووقع هنا .
أحيانا بطني بتوجع.	تؤلمني معدتي أحياناً .
نعم، أنا عندي تزكرتين للجيانتس و دودقرس.	"أجل ، معي تذكرتان ل "" العمالقة "" و "" المحتالين "" ."
نحن واحد من قمة الموردين بتاعين المايكروكمبيوترات.	نحن من أكبر موردي أجهزة الميكروكومبيوتر .
شكرا ليك. أنا برضه. مع السلامة لغاية الوقت داك.	شكراً . وأنا أيضاً . إلى اللقاء فيما بعد .
غرفة مزدوجة مع حمام، من فضلك.	حجرة مزدوجة بحمام من فضلك .
أنا وقعت على السلالم.	لقد سقطت من على درجات السلم .
ياتو اسكريم انت بتزكي؟	ما هو الآيس كريم الذي تزكيه ؟
نعم، أنا هو. اعتادوا يسكنوا جنبي في كاليفورنيا لكن انتقلت الى فلوريدا قبل سنتين. كيف عنك انت؟ هل بتسافر براك؟	أجل ، أنا . لقد كانوا يعيشون بجواري في كاليفورنيا لكنهم انتقلوا إلى فلوريدا منذ عامين . ماذا عنك ؟ هل تسافر بمفردك ؟
انا عيان.	أنا مريض .
طفلي شكله مرهق نتيجة الحمى.	يبدو طفلي منهكاً بسبب الحمى .
درجات المزايا الثقافية يبدوها لفنانين وعلماء مميزين في اليوم داك.	تمنح أوسمة الاستحقاق الثقافي للفنانين والعلماء المتميزين في هذا اليوم .
انا ياباني. سعر الغرفة هو ستة ألف ين لليلة.	أنا ياباني .
داك غالي شديد.	هذا ثمنه مرتفع جداً .
نعم. اخد البص البمشي لي كيوتوايكي.	أجل . استقل الحافلة التي تذهب إلى محطة كيوتو .
هل هو للأعضاء فقط؟	هل هذا للأعضاء فقط ؟
ممكن اجيب دا في ركوب الطيارة؟	هل يمكنني أن أحضر هذا على متن الطائرة ؟
اوكي. كل الداير أعرفه ما إذا كان العمل أبدا ح يدفع بطريقته.	حسناً . كل ما أريده هو معرفة إذا ما كان المشروع سيحقق ربحاً .
تمام. داير وشاح عشان يمشي مع داك؟	جميل . هل تريدين إيشارباً يتناسب مع هذا ؟
أعد شحن البطاريه، من فضلك.	أعد شحن البطارية من فضلك .
اكتب اسم الخطوط الجوية و رقم الرحلة، برضه.	اكتب اسم شركة الطيران ورقم الرحلة أيضاً .
حقيقة. اليوم هو الأحد، و الأحد اكعب يوم.	حقاً . اليوم هو الأحد ، والأحد هو أسوء الأيام .
نعم، هي مشكلة عدم تصرف.	أجل . إنها مشكلة تخلص من الفضلات .
داير الشكل دا في وضع خمسة أماكن.	أريد هذا الطراز لخمسة أماكن مرصعة .
أسر كثيرة عندهم دخول مزدوجة.	لدي معظم العائلات مصدرين للدخل .
"اوه. الفضة دي نادرة ""القمر و الجرس"" . اكيد داير تبادلا؟"	"آه . هذه الفضية نادرة "" القمر والجرس "" . هل تريد أن تغيرها أكيد ؟"
أمي و اختي جاين من اليابان عشان يشوفوني . ح يوصلوا حوالي سبعة في المساء.	أمي وأختي قادمتان من اليابان لرؤيتي . سيصلان هنا حوالي السابعة مساءً .
البني شعبي جدا السنة دي.	اللون البني محبب هذا العام .
أوكي. مقعدين، من فضلك.	حسنا . مقعدان من فضلك .
وين السوق؟	أين السوق ؟
أنا بفتش لطريقة لتجريب بدلة السباق حقتي.	أود قياس بذلة السباق الخاصة بي .
أنا اعتقدت ي شباب أنكم اكلتوا دونات.	ظننت أنكم أيها الشباب تأكلون الكعك المخبوز فقط .
كم تكلفة تزكرة درجة أولى إلى ادينبيره، من فضلك؟	ما سعر تذكرة درجة أولى إلى إدنبره , من فضلك ؟
يبدو أن القروش الاديتني ليها أقل بعشرة دولارات.	يبدو أن النقود التي أعطيتني إياها ناقصة عشر دولارات .
داير واحد حديث.	أريد واحدة حديثة .
أنا شغال لشركة نشر.	أعمل في شركة نشر .
ممكن من فضلك تملأ دا؟	هل لك أن تتفضل وتملأ هذه ؟
واصل المشي في الممر دا، ثم ح تلقاه على الجانب اليمين.	ظل سائراً عبر هذا الممر , وستجدها على الجانب الأيمن .
داير أأكد دا.	أريد التأمين على هذا .
صباح الخير. مكتب الاستقبال. ممكن اساعدك؟	صباح الخير . هذا مكتب الاستقبال . هل لي أن أساعدك ؟
من فضلك اديني تلاتة اتنين ستة اتنين تسعة واحد تمنية.	من فضلك اتصل لي برقم ثلاثة اثنان ستة اثنان تسعة واحد ثمانية .
نعم، ممكن نخدمك من سبعة.	أجل , يمكننا القيام بخدمتك بداية من السابعة .
من فضلك ارقد هنا.	من فضلك استلق هنا .
من فضلك لف شمال في التقاطع الجاي.	من فضلك اتجه يساراً عند التقاطع التالي .
نعم. اسمك و رقم غرفتك، من فضلك.	أجل . اسمك ورقم غرفتك , من فضلك .
كم من الزمن تستغرق عشان يوصل اليابان بالبريد الجوي؟	كم المدة التي يستغرقه لكي يصل لليابان عن طريق البريد الجوي ؟
أوكي. اشوفك عند الثانية في الأحد.	حسناً . أراك الساعة الثانية يوم الأحد .
داير أمشي خلال نيويورك إلى تورونتو.	أريد أن أمر بنيويورك في طريقي إلى تورونتو .
دا نوع من الوساخة.	هذا ضرب من الدناءة .
ممكن احصل علي شوكة جديدة؟	هل لي بشوكة أخرى ؟
شكرا ليك كتير للطفك.	شكراً جزيلاً لعطفك .
داير اشوف دا.	أريد أن أرى هذا .
اوه، داك جميل. مفروض اعمل شنو؟	آه ، هذا جميل . ماذا علي أن أصنع ؟
من فضلك غير مقعدي.	من فضلك غير مقعدي .
عندنا بعض الجمبري الجيد اليوم.	لدينا جمبري رائع جداً اليوم .
لياتو تأخير هو بفتح؟	إلى أي ساعة متأخرة تظل مفتوحة ؟
هو غالي شديد لي. ما ممكن تعمله ارخص؟	إنه غالي جدا بالنسبة لي . ألا يمكنك تخفيض السعر قليلاً ؟
أنا ما عملت حجز.	لم أقم بالحجز .
لأن الصيف في اليابان عادة سخن شديد، و نحن ما عندنا مكيف هواء في الأيام القديمة.	لأن الصيف في اليابان عادة ما يكون شديد الحرارة ، ولم يكن لدينا تكييف هواء قديماً .
ممكن تنادي لي تاكسي صباح بكرة؟	هل لك أن تستدعي لي سيارة أجرة الساعة الثامنة صباح غد ؟
إنه شرير.	إنه مريب .
لي ما ننتظر البص في المظلة؟	لماذا لا ننتظر الحافلة تحت التندة ؟
نعم، هو مفتوح من تسعة لتسعة.	أجل ، إنها مفتوحة من التاسعة حتى التاسعة .
كيف أثر الركود في العمل؟	كيف أثر الركود على الشركة ؟
عندي موعد تاني.	لدي موعد آخر .
ممكن احصل علي خريطة شارع؟	هل لي بخريطة لطرق المدينة ؟
انا ما فاهم توضيحاتك.	لا أفهم شرحك .
مفروض يعمل اتصال. ماشي لبوسطن.	كان يجب تدبير وسيلة مواصلات . ذاهبة إلى بوسطن .
وين أحسن مكان للسياحة؟	أين أفضل مكان لمشاهدة المعالم ؟
هو متين؟	هل هي متينة ؟
طيب تمام، داير يكون عندي وش أصغر زي جوليا روبرتس.	حسنا إذاً ، أريد عصا مضرب أصغر كتلك التي مع جوليا روبرتس .
ممكن تشيل دا، من فضلك؟	هل لك أن تأخذ هذا ، من فضلك ؟
دايرني اخد صورتك؟	هل تريدني أن ألتقط لك صورة ؟
ما عندي الصحن دا.	لم يكن لدي هذا الطبق .
انا قطعت مصبعي. هل هناك مطهر؟	لقد قطع إصبعي . هل يوجد مطهر ؟
هل ممكن احصل علي طابعة بخمسة وتسعين سنت؟	هل يمكنني الحصول على طابع فئة خمسة وتسعين سنتاً ؟
ح أكون هنا عند التامنة إلا ربع.	سأكون هنا الساعة الثامنة إلى الربع .
داير بعض العطر.	أريد عطراً .
هل فندق الهيلتون بعيد من هنا؟	هل فندق هيلتون بعيد عن هنا ؟
انا متأكد اني ختيته في شنطتي.	أنا متأكد أنني وضعتها في محفظة الأوراق الخاصة بي .
الايادي فوق.	ارفعوا أيديكم .
هل هناك كافيتريا بتزكيها قريب من هنا؟	هل يوجد مطعماً يمكنك أن تزكيه بالقرب من هنا ؟
ياتو انت بتفضل؟ غامض ول فاتح؟	أيهما تفضل , داكن أم فاتح ؟
ممكن تكلمني وين نحن طايرين؟	هل لك أن تخبرني عن مكان تحليق الطائرة الآن ؟
تزكرة تحويل، من فضلك.	تذكرة نزول وركوب طائرة أخرى من فضلك .
لسة ح يعمل الجدول داك؟	هل ستزال تعمل جدول المواعيد ؟
ما الزمن البفتح فيه البنك؟	متى يفتح المصرف ؟
انا أشعر تمام.	أشعر بالإعياء .
أنا بقيت مشوش. هل تمانع ترسم لي خريطة؟	سأرتبك . هل تمانع في رسم خريطة لي ؟
بطني تؤلم.	معدتي تؤلمني .
كم سعر البريد عشان أرسل الرسالة دي لليابان؟	كم أجرة البريد لإرسال هذا الخطاب إلى اليابان ؟
داير كاس شيري.	أريد زجاجة من نبيذ شيري الأسباني .
هل انت بتحتاج تترفع من المطار؟	هل تريد أن يأتي أحد ليأخذك من المطار ؟
من تلاتين ألف ين.	من ثلاثين ألف ين .
وين ممكن اشتري بطاقة هاتف؟	من أين يمكنني شراء بطاقة هاتف ؟
هل ممكن أرجعه في مدينة مختلفة؟	هل يمكنني إعادتها في مدينة مختلفة ؟
من فضلك خلي القمة أطول شوية.	من فضلك اجعل الجزء العلوي أطول قليلاً .
انت محتاج تشوف أخصائي.	تحتاج لرؤية أخصائي .
داير نسخة من تقرير السرقة.	أريد نسخة من تقرير السرقة .
ممكن تديني نور لم تكون عنده؟	هل لك أن تعطيني إشارة بالضوء عندما تكون فيها ؟
داير الأكمام بتاعت الجاكيت الرياضي دا تتطول.	أود أن أجعل أكمام هذا الجاكت الرياضي طويلة .
عندي حجز. دا رقم التأكيد.	لدي حجز . هذا هو رقم تأكيد الحجز .
عيد ميلادك في الطريق.	عيد ميلادك اقترب .
هل يمكنك تصليح دا؟	هل يمكنك أن تصلح ذلك ؟
هو المبنى التاني على الشمال بتاع المبنى الأبيض داك.	إنه المبنى الثاني على يسار هذا المبني الأبيض .
لا، زيادة شوية في المقدمة. هناك، أيوة.	لا . قليلاً في الأمام . هناك ، نعم .
نعم، داك ما بشمل وجبات.	نعم ، هذا لا يشمل الوجبات .
وين ممكن ارجع قيمة التزكرة دي؟	أين يمكنني استعادة ثمن هذه التذكرة ؟
لي هو بحصل؟	لماذا يحدث هذا ؟
داير اخد راحة.	أريد أن أحصل على استراحة .
داير شعري أطول شوية في الخلف.	أريد أن يكون شعري خلف رأسي أطول قليلاً .
ياتو أنواع عندك؟	ما هي الأنواع التي لديكم ؟
ياتو نوع من الموديلات عندك في بالك؟	ما هو نوع النموذج الذي تفكر فيه ؟
ممكن من فضلك ترسم لي خريطة بسيطة من هنا؟	من فضلك ، هل رسمت لي خريطة بسيطة من هنا ؟
وين بنتلاقى؟	أين نتقابل ؟
داير شعري يتظبط زي ما كان.	أود تصفيف شعري بالطريقة التي كان عليها من قبل .
اديني خمسين، من فضلك.	أعطني خمسين ، من فضلك .
وين ممكن اسجل في الخطوط الجوية اليابانية؟	أين يمكنني أن أقوم بإجراءات الدخول للخطوط الجوية اليابانية ؟
المحتويات شنو؟	ما هي المحتويات ؟
اديني بعض الفكة، من فضلك.	من فضلك أعطني بعض الفكة .
كلو تمام. انا ح أتأكد ان شنطك ح يكونوا هنا.	حسناً . سأتأكد أن حقائبك ستكون هنا .
دا تخصصنا، قريلد دوفر سول.	هذا هو طبقنا المميز , سمك موسى المشوي الخاص بدوفر .
نحن ح نكون قاعدين.	سنمكث .
كله تمام. هل على اركزه؟	حسناً . هل يجب أن أقوم بتركيزها ؟
سكوتش و موية، من فضلك.	ويسكي اسكتلندي وماء من فضلك .
داك شكله حلو. كم بيكلف؟	هذا يبدو رائعاً . ما الثمن ؟
شيل الوصفة الطبية دي لصيدلية. ممكن تحصل على الدواء هناك.	خذ هذه التذكرة الطبية إلى الصيدلية . يمكنك الحصول على الدواء من هناك .
طلبت داك.	لقد طلبت ذلك .
نعم، ممكن تقيف في أي محطة بين هنا و شيكاغو.	نعم , يمكنك أن تتوقف في أي محطة ما بين هنا وشيكاغو .
وين ممكن اشتري بعض التذكارات؟	من أين يمكنني شراء بعض الهدايا التذكارية ؟
هو غالي جدا. انا ما بقدر اشتريه.	إنها غالية الثمن . لا أستطيع شرائها .
ممكن احصل على رقم ايه بي سي اند كمباني في شيكاغو، من فضلك.	هل يمكنني أن أحصل على رقم تليفون إيه بي سي والشركة في شيكاغو من فضلك ؟
كيف داير بيضك؟	كيف تحب أن تأكل البيض ؟
هو بعد المبنى دا طوالي.	يوجد بجانب هذا المبني تحديداً .
لا، أعتقد أنهم نسوا يجيبوا لينا واحد.	لا , أعتقد أنهم نسوا أن يحضروا واحدة لنا .
أوكي. أتأكد. ممكن نحصل على رقمك، بس في حالة دايرين نتصل عليك؟	حسناً . لقد تم التأكيد . هل يمكننا أن نأخذ رقم تليفونك في حالة الحاجة إلى الاتصال بك ؟
اسم الدهان دا منو؟	ما هو اسم الرسام ؟
هل اخليه يرجع يتصل عليك لم يجي داخل؟	هل أجعله يعاود الاتصال بك عندما يعود ؟
داير أملك الواحد داك.	أود أن آخذ هذا .
أنا بحب الخدمة دي بتاعت الترحيب بالشامبانيا بعد الركوب. خليني اشرب في صحتك.	أحب هذه الخدمة بتقديم شامبانيا للتحية بعد الإقلاع . دعني أشرب فى صحتك .
أربعين دولار لليوم زايد تمنية سنت للميل.	أربعون دولار يومياً ، بالإضافة إلى ثمانية سنت لكل ميل .
ممكن توريني كيف أصل للمتحف؟	هل قلت لي كيف أذهب إلى المتحف ؟
أنا آسف جدا، لكن داير ااجل الموعد.	آسف جدا ، لكني أود تأجيل الميعاد .
قطرك ح يغادر من الرصيف تمنية.	سيغادر قطارك من الرصيف رقم ثمانية .
انا بفتش لشنطة مع شريط يمكن يتعدل.	أبحث عن شنطة بحزام متحرك .
دايره يبقى تحت مية و تمنين دولار.	أود أن تبقي تحت مائة وثمانين دولار .
ح أسألك بعد اكون فتشت الأرجاء.	سأسلك بعد أن ألقي نظرة هنا وهناك .
ممكن توريني واحدات تانية من تصميم مختلف؟	هل يمكنك أن ترني أشياء أخري ذات تصميمات مختلفة .
ياتو نوع من العصير انت بتحب؟	ما نوع العصير الذي تفضله ؟
هل انت ماشى البيت للاعياد؟	هل ستعود لبلادك في الاجازات ؟
داير أرسل دا بالبريد الجوي لليابان.	أود أن أرسل ذلك إلى اليابان بالبريد الجوي .
يوم شكر العمال. هو يوم شكر لأولئك البدعموا المجتمع بأعمالهم.	عيد الشكر والعمال ، فهو يوم الشكر لكل الذين ساندوا المجتمع بأعمالهم .
الغرفة دي صغيرة شديد.	هذه الغرفة صغيرة جداً .
هل هناك بنك حوالي هنا؟	هل يوجد بنك بالقرب من هنا ؟
سكين، من فضلك.	سكين ، من فضلك .
كلهم مسألة مطبوعة.	هذه كلها مطبوعات .
من فضلك اكتب رقم غرفتك في الخلف.	من فضلك ، اكتب رقم الغرفة في الخلف .
بنستخدم عيدان الطعام لمن نأكل.	نستخدم الأعواد عندما نأكل .
رحلة دلتا رقم تمنية وعشرين إلى نيو اورلينز ح تتأخر حوالي ساعة.	رحلة الطيران دلتا رقم ثمانية وعشرون والمتجهة إلي نيو أورلينز سوف تتأخر حوالي ساعة .
لم أرجع لليابان، ح اكتب رسالة. لو عندك زمن، من فضلك رسل لي رسالة.	عندما أعود ثانية إلى اليابان ، سأكتب خطاباً . وإذا كان لديك وقت ، من فضلك أرسل لي خطاباً .
انا خليته تزكرتي حقت الخطوط الجوية في الفندق.	نسيت تذكرة الطيران الخاصة بي في الفندق .
غرفة سنقل بدون دش، من فضلك.	غرفة مفردة بدون دش من فضلك .
شكرا تاني لتزكيري . هل ناس كتار بيتعمدوا ينسوا يوقعوا اسمائهم؟	أشكرك ثانية لأنك ذكرتني . هل يميل كثير من الناس أن ينسوا توقيع أسمائهم ؟
طيب، نحن نجري خارج الزمن. هل نواصل النقاش دا في الخميس عند الواحدة؟	حسناً . ليس لدينا وقت . هل يمكن أن نكمل هذه المناقشة يوم الخميس في الساعة الواحدة ؟
أوكي. ح اتصل بيك لم يجهزوا.	حسناً . سأتصل بك عندما يكونوا جاهزين .
كيف عن الغداء؟	ماذا عن الغداء ؟
إلى كم من التأخير ممكن استعمل كافيتريا الفندق؟	إلى متي يظل مطعم الفندق متاحا للاستخدام من قبلي ؟
طيب، انه متاخر شديد. أعتقد أني مفروض أغادر الآن. شكرا ليك كتير للمساء الرائع.	حسنا , الوقت متأخر إلى حد ما . أعتقد أنني يجب على أن أغادر الآن . شكرا جزيلا لك على الأمسية الرائعة .
ممكن آخد بعض الدواء لوجع بطني؟	هل لي أن أتناول بعض الدواء لآلام في معدتي ؟
داير جداد مشوي.	أود أن أتناول فراخ مشوية .
غلطي. ما غلطك.	إنه خطئي . ليس خطأك .
أعذرني، متين بنتهي الفلم دا؟	معذرة , متي ينتهي هذا الفيلم ؟
اهلا. دي خطوط يونايتيد الجوية.	مرحبا . هذه هي الخطوط الجوية المتحدة .
عندي واحد أصغر بنفس التصميم.	لدي واحدة صغيرة من نفس التصميم .
ممكن تضيق السروال دا؟	هل يمكنك ترتيب هذه البناطيل ؟
ليلة الجمعة، في التاسعة.	مساء الجمعة , في التاسعة .
ملعقة تانية، من فضلك.	ملعقة أخرى , من فضلك .
إنه مالح شوية، لكن بحبه، هل انت جبته معاك كل الطريق من اليابان؟	إنها مالحة قليلا , لكنني أحبها . هل أحضرتها معك طوال الطريق من اليابان ؟
من فضلك سرعه، لو ممكن.	قم بدفعها من فضلك , إن كان ذلك ممكنا .
هل ممكن تدفع عشرة دولارات هنا كعربون؟	هل من الممكن أن تدفع مبلغ عشرة دولارات للمقدم ؟
نعم. صحيني بعد تلات ساعات، من فضلك.	نعم . أيقظني من النوم بعد ثلاثة ساعات , من فضلك .
الاستوب الجاي شنو؟	ما هي المحطة القادمة ؟
هل اخدت دواء لبطن قالبة؟	هل تناولت دواء لتقلبات المعدة ؟
هل بحتاج البس جاكيت و كارافتة؟	هل أحتاج إلى أن أرتدي معطف و رابطة عنق ؟
ممكن احول قروش لحسابي بتاع الادخار؟	هل يمكنني أن أحول أموال إلى حساب المدخرات الخاص بي ؟
نسيت شنطتي.	لقد نسيت أن آخذ حقيبتي اليدوية .
ساعتي. كانت صنف جديد صناعة سويسرية ديجتال.	ساعتي . لقد كانت ساعة رقمية ماركة حديثة سويسرية الصنع .
ممكن أمشي اشوف معالم المدينة أثناء وجود السفينة في الميناء؟	هل يمكن أن أذهب لمشاهدة المعالم أثناء رسو السفينة في الميناء ؟
أنت أحسن تعدل المراية الخلفية.	من الأفضل أن تضبط المرآة العاكسة للرؤية الخلفية .
ح أكون سعيد. ياتو زمن بتحب؟	سأكون سعيدا بذلك . متى ترغب في ذلك ؟
اجمعهم في البوابة.	اجمعهم عند البوابة .
إما تصلحه أو تبدله، من فضلك.	إما أن تصلحها أو تستبدلها ، من فضلك .
ممكن اعمله أحيانا الشهر الجاي.	يمكنني القيام بها في وقتا ما الشهر القادم .
من فضلك اخد زمنك.	من فضلك تروى .
كيف المنتج الجديد دا يقارن مع المنتجات الموجودة؟	كيف يتم مقارنة هذا المنتج الجديد مع المنتجات الموجودة ؟
كتاب المبيعات عطوفين جدا في المتجر دا.	موظفو المبيعات في هذا المتجر لطفاء جداً .
ممكن تحفظ لي دا؟	هلا احتفظت بهذا لي ؟
دقيقة بس، من فضلك.	دقيقة فقط ، من فضلك .
هل عندك بطاقات الاستلام حقتك؟	هل لديك بطاقات ادعائك ؟
داير أأجر عربية لأسبوع.	أرغب في تأجير سيارة لمدة أسبوع .
من فضلك وريني بعض الساعات للرجال.	من فضلك أرني بعض الساعات الرجالي .
إنه أربعة عشرة.	إنها أربعة عشرة .
نحن أحسن نسرع. هم بالفعل بركبوا.	من الأفضل أن نسرع . انهم يركبون بالفعل .
سألت عن جداد.	طلبت دجاجا .
لعشرة أيام.	لمدة عشرة أيام .
كم عمر الولد دا؟	كم عمر هذا الصبي ؟
كم كله كدا؟	كم التكلفة كلها ؟
داير نفس داك، من فضلك.	أريد نفس الشيء ، من فضلك .
أنا ضيعت شيكات المسافر حقتي.	لقد فقدت شيكاتي السياحية .
من فضلك اديني بعض دواء النزلة.	من فضلك أعطني دواء للبرد .
انا دايما بشوفه كل صباح في القطر.	أراه دائما كل صباح في القطار .
ممكن تتعشي معانا المساء دا؟	هل تستطيع أن تتناول العشاء معنا هذا المساء ؟
ح أقعد في فندق بي لغاية بكرة. ح اكون سعيد لو كلمته اني هنا.	سأقيم في فندق بي حتى غداً . أكون مسروراً إذا أخبرته أنني هنا .
رحلة أخرت لخمسة وأربعين دقيقة.	تأجلت الرحلة الجوية لمدة خمسة وأربعين دقيقة .
اسمي شينو يامادا.	اسمى شينو يامادا .
الكافيتيريا دي تخصصها شنو؟	ما هو تخصص هذا المطعم ؟
بس بعض دواء النزلة.	فقط دواء للبرد .
الو، هل دا رويس؟	هالو ، هل هذه تعود إلى روي ؟
لا، ما هنا. هناك غرفة تدخين في مؤخرة العربة دي.	لا ، ليس هنا . هناك حجرة تدخين قرب مؤخرة هذه الحافلة .
ممكن احصل على دليل؟	هل لي بدليل سياحي ؟
نعم، سيدي. كيف دايرني اقطعه؟	نعم ، سيدي . كيف تريدني أن اقطعها ؟
فقط زيت و خل ح يكون كويس.	زيت و خل فقط سيكون جيداَ .
عندي تحديدا الدايره انت. ممكن أقترح دا؟	لقد فهمت ما أردت أنت بالضبط . هل لي أن اقترح ذلك ؟
قهوة بسكر.	قهوة بالسكر .
شكرا ليك. من فضلك تعال راجع تاني.	شكراً لك . من فضلك عاود مرة أخرى .
هل بتعتقد كدا؟	أتظن ذلك ؟
داير أعمل مكالمة لليابان.	أريد الاتصال هاتفياً باليابان .
ياتو نوع عندك في بالك؟	ما النمط الذي في مخيلتك ؟
إذا لقيت اي حاجة، من فضلك اتصل على.	إن عثرت على شيء ، اتصل بي من فضلك .
ممكن احصل على بعض لحم الخنزير و بيض؟	هل لي في شيء من لحم الخنزير والبيض ؟
الموية السخنة ما ساخنة كفاية.	المياه الساخنة ليست ساخنة بالقدر الكافي .
من فضلك أكتب عنوانك هنا.	من فضلك سجل عنوان الاتصال بك هنا .
ممكن استخدم فلاش؟	هل يمكنني استخدام إِشارة ضوئية ؟
شكرا ليك. تعال راجع لغرفتي في نفس الزمن بكرة. ح يكون عندي الصور جاهزة بذلك الوقت.	شكراً . عد إلى غرفتي في نفس الوقت غدا . ستكون الصور جاهزة . قبل ذلك .
أنا آسف الآن انت ممكن تطلب فقط من المنيو الليلي.	آسف فالآن لا يمكنك الطلب سوى من قائمة الطعام الليلية .
عندي صداع.	أشعر بصداع .
هل هنا في مستشفى حوالي هنا؟	هل ثمة مستشفى قريب من هنا ؟
داير بدلة.	أريد بزة .
فندق آمن بخدم فطور عظيم، من فضلك.	أريد فندقاً آمنا يقدم إفطاراً جيدا ، من فضلك ؟
وين حديقة الحيوان؟	أين حديقة الحيوان ؟
واحدات أكبر؟	هل لديك أحجام أكبر ؟
بيعتمد على كيفية دفء المكان، لكن في وسط اليابان، بداية أبريل.	يتوقف الأمر على درجة حرارة المكان . ولكن في وسط اليابان , في أوائل أبريل .
بيرقر بالجبنة و مقليات.	أريد سندويتش برجر بالجبن ومقليات .
إنه متأخر جدا لآخر قطر.	لقد بالغ آخر قطار في التأخر .
ما عندي اي فكة.	ليس معي فكة صغيرة .
هل حصلت على تزكرة بصك؟	هل أخذت تذكرة الحافلة ؟
رصيد، من فضلك.	البطاقة الائتمانية ، من فضلك .
كنت في رحلة خطوط يونايتد تمنية اتنين تمنية.	كنت على رحلة يونيتد إيرلاينز رقم ثمانية اثنان ثمانية .
إنه مزعج جدا حول الغرفة.	إن حول غرفتي ضجيجا بالغا .
في الساحل الشرقي، انت برضه ألقى محلات مشهورة، زي نيويورك، واشنطن دي سي و بوسطن.	على الساحل الشرقي ، تجد أيضاً أماكن شهيرة . مثل نيويورك ، واشنطن ، دي دي وبوسطن .
يبدوا جيدا.	هذا طيب ، على ما يبدو .
كله تمام إذا خليت عفشي معاك لغاية الساعة واحدة؟	هل تمانع في أن أترك حقائبي معك حتى الساعة الواحدة ؟
هل هناك جولة للمدينة؟	هل ثمة رحلة في المدينة ؟
نعم. أنا لازم. كيف الأمن في المنطقة دي؟	أجل . أخشى أني مضطر لذلك . ما مدى حفظ الأمن في هذه المنطقة ؟
أنا شايف. بحاول أأجر سيتروين.	أفهم ذلك . أحاول استئجار سيارة سيتروين .
داك بكون كويس. وين العيش؟	هذا رائع . أين الخبز ؟
مدخن، من فضلك. و مقعد شباك، من فضلك.	ركن المدخنين ، من فضلك . وشباك بجوار النافذة ، من فضلك .
و كم سعرك للخياطة؟	كم تتقاضى نظير التفصيل ؟
هل عندك التي شيرت دا بأي لون تاني؟	هل لديك ألوان أخرى لهذا التي شيرت ؟
أيوة، نحن جاين عليه، جاين عليه.	أجل ، إننا على وشك معالجته ، على وشك معالجته .
وين ممكن ألقى سوبرماركت؟	أين يمكنني أن أجد سوبر ماركت ؟
إنه غالي شوية. ما ممكن تديني بريك؟	إنه غالي الثمن إلى حد ما . ألا يمكنك منحي خصماً ؟
كم استوب لغاية اغير؟	كم محطة قبل التحويل ؟
الراجل داك سرق محفظتي.	لقد سرق ذلك الرجل كيس نقودي .
حبوب الهضم و هبوب ألم المعدة مختلفات، صاح؟	حبوب عسر الهضم تختلف عن حبوب ألم المعدة ، أليس كذلك ؟
كم من الزمن بياخد بالرجل؟	كم تستغرق مشياً على الأقدام ؟
ح اخد عشرين من أكبر خمرة تيدي، من فضلك.	سآخذ عشرين دب لعبة من أكبر حجم .
إنه ساهل. انا فقط ح انظر لكتاب التلفون.	الأمر يسير . سأنظر في دليل الهاتف فحسب .
كم فاتورتي؟	كم فاتورة الحساب ؟
حابي اني أقعد في الغرفة دي لليلة إضافية.	أود الإقامة بهذه الغرفة ليلة واحدة أخرى .
اعزرني، لكن انا داير اسلم تقرير السرقة.	معذرة . ولكني أريد تسليم تقرير السرقة .
هل تمانع إذا قعدت هنا؟	هل تمانع في جلوسي هنا ؟
هل ممكن أرسل ايميل واحد فقط بدولار؟	هل يمكنني أن أرسل أي ميل واحد فقط قيمته دولار .
نعم، من فضلك رسله لغرفة اتناشر أربعة وتلاتين.	أجل ، من فضلك أرسله إلى الغرفة اثنا عشر أربعة وثلاثون .
بأي زمن مفروض اجي المطار؟	متى يتعين على الوصول إلى المطار ؟
دا بطئ.	هذه السرعة بطيئة .
وين ممكن اطور فيلم؟	أين يمكنني طباعة الفيلم ؟
آسف المرحاض ما شغال. أنا محتاج مساعدة.	آسف الحمام به عطل . أحتاج للمساعدة .
ح آخدك لمقعدك. الشارع دا، من فضلك.	سأذهب بك على مقعدك . من هنا ، من فضلك .
اعزرني، ممكن أسألك سؤال؟	معذرة ، هل يسعني أن أتوجه إليك بسؤال ؟
داير اسجل العفش لطوكيو، من فضلك.	أريد فحص هذه الحقائب المتجه إلى طوكيو , من فضلك .
هل ح توريني واحد أكبر شوية؟	هل يمكنك أن تريني حجماً أكبر بقليل ؟
أعتقد أن الملابس المصنوعة في اليابان قطعا مصممة أحسن.	أظن أن الملابس المصنوعة في اليابان قد جرى تفصيلها على نحو أفضل بالتأكيد .
كان عليك أن تستسلم.	الأجدر بك أن تكف عن ذلك .
ياتو مطار انا مغادر منو؟	من أي المطارات سأغادر ؟
ما استلمت الفورمة في الطيارة؟	ألم تتلق الاستمارة بالطائرة ؟
انا داير مكوة.	أريد مكواة .
أنا بعمل تزلج مرتين بالشهر خلال الموسم.	إني أتزلك مرتين في الشهر خلال الموسم .
انا ولدت في واحد أبريل في ألف وتسعمية خمسة وخمسين.	ولدت في أول أبريل سنة ألف وتسعمائة وخمس وخمسين .
هو لشنو؟	ما الغرض منها ؟
وين ممكن أمشي للاجراءات الرسمية؟	أين يمكنني أداء الإجراءات الرسمية ؟
من فضلك نادي إسعاف.	من فضلك استدع سيارة إسعاف .
كيف هو جاي؟	كيف تسير الأمور ؟
ما في أكل المابحبه.	ليس ثمة طعام لا أحب أكله .
هل الجولة دي بتشمل زيارة إلى برج ميرس؟	هل تشمل هذه الرحلة زيارة لبرج سيرز ؟
في مكتبة هنا؟	هل ثمة محل قريب لبيع الكتب ؟
انا ح أحضر المدرسة الصيفية في جامعة هاواي.	سأحضر المدرسة الصيفية بجامعة هاواي .
اتنين بالغين و طفل عمره تلاتة سنوات.	اثنان كبار وطفل عمره ثلاث سنوات .
في حمام في المحطة.	في غرفة انتظار بالمحطة .